market,candle_date_time_utc,candle_date_time_kst,opening_price,high_price,low_price,trade_price,timestamp,candle_acc_trade_price,candle_acc_trade_volume,prev_closing_price,change_price,change_rate,RSI,prev_close,change,gain,loss
KRW-BTC,2021-12-21,2021-12-21T09:00:00,57980000,60650000,57500000,60023000,1.64013E+12,3.94353E+11,6637.670907,58011000,2012000,0.034683077,0,58329000,-318000,0,318000
KRW-BTC,2021-12-22,2021-12-22T09:00:00,60023000,60772000,59605000,59753000,1.64022E+12,3.47172E+11,5773.963745,60023000,-270000,-0.004498276,86.35193133,58011000,2012000,2012000,0
KRW-BTC,2021-12-23,2021-12-23T09:00:00,59759000,61925000,59120000,61490000,1.6403E+12,3.89082E+11,6471.529895,59753000,1737000,0.02906967,77.38461538,60023000,-270000,0,270000
KRW-BTC,2021-12-24,2021-12-24T09:00:00,61490000,62850000,61250000,61939000,1.64039E+12,3.2569E+11,5243.54315,61490000,449000,0.007302,86.44224118,59753000,1737000,1737000,0
KRW-BTC,2021-12-25,2021-12-25T09:00:00,61939000,62500000,61107000,61177000,1.64048E+12,2.3068E+11,3730.367984,61939000,-762000,-0.012302427,87.71416632,61490000,449000,449000,0
KRW-BTC,2021-12-26,2021-12-26T09:00:00,61177000,61939000,60288000,61467000,1.64056E+12,2.6503E+11,4350.543669,61177000,290000,0.004740344,75.66690699,61939000,-762000,0,762000
KRW-BTC,2021-12-27,2021-12-27T09:00:00,61467000,62500000,60934000,61508000,1.64065E+12,3.25512E+11,5287.225194,61467000,41000,0.000667025,76.87564234,61177000,290000,290000,0
KRW-BTC,2021-12-28,2021-12-28T09:00:00,61470000,61508000,57912000,58274000,1.64074E+12,4.3662E+11,7303.087277,61470000,-3196000,-0.051992842,76.88751926,61467000,3000,3000,0
KRW-BTC,2021-12-29,2021-12-29T09:00:00,58261000,58763000,56650000,57089000,1.64082E+12,4.65099E+11,8037.999545,58274000,-1185000,-0.020334969,49.69569547,61470000,-3196000,0,3196000
KRW-BTC,2021-12-30,2021-12-30T09:00:00,57089000,58233000,56400000,57200000,1.64091E+12,3.15379E+11,5506.789813,57089000,111000,0.001944333,43.93465075,58274000,-1185000,0,1185000
KRW-BTC,2021-12-31,2021-12-31T09:00:00,57233000,58812000,56233000,56784000,1.641E+12,2.85728E+11,4959.970086,57200000,-416000,-0.007272727,44.53692055,57089000,111000,111000,0
KRW-BTC,2022-01-01,2022-01-01T09:00:00,56784000,58271000,56762000,57915000,1.64108E+12,1.51065E+11,2628.145965,56784000,1131000,0.019917582,42.81328496,57200000,-416000,0,416000
KRW-BTC,2022-01-02,2022-01-02T09:00:00,57915000,58300000,57100000,57531000,1.64117E+12,2.05291E+11,3567.505712,57915000,-384000,-0.006630407,48.25757576,56784000,1131000,1131000,0
KRW-BTC,2022-01-03,2022-01-03T09:00:00,57540000,57749000,56133000,56641000,1.64125E+12,3.60063E+11,6304.958564,57531000,-890000,-0.015469921,46.74657534,57915000,-384000,0,384000
KRW-BTC,2022-01-04,2022-01-04T09:00:00,56640000,57685000,56000000,56023000,1.64134E+12,3.42513E+11,6053.445802,56641000,-618000,-0.010910824,44.66344656,57531000,-890000,0,890000
KRW-BTC,2022-01-05,2022-01-05T09:00:00,56023000,57100000,52701000,53854000,1.64143E+12,5.15277E+11,9296.798714,56023000,-2169000,-0.038716242,32.52053837,56641000,-618000,0,618000
KRW-BTC,2022-01-06,2022-01-06T09:00:00,53854000,54300000,52388000,53239000,1.64151E+12,3.39631E+11,6389.079302,53854000,-615000,-0.011419765,27.89146241,56023000,-2169000,0,2169000
KRW-BTC,2022-01-07,2022-01-07T09:00:00,53240000,53358000,50900000,51449000,1.6416E+12,3.89528E+11,7509.108093,53239000,-1790000,-0.033621969,16.23700794,53854000,-615000,0,615000
KRW-BTC,2022-01-08,2022-01-08T09:00:00,51449000,52709000,50829000,52142000,1.64169E+12,2.15424E+11,4171.096458,51449000,693000,0.01346965,11.320059,53239000,-1790000,0,1790000
KRW-BTC,2022-01-09,2022-01-09T09:00:00,52142000,52600000,51144000,51678000,1.64177E+12,1.7487E+11,3369.09509,52142000,-464000,-0.008898776,16.51471351,51449000,693000,693000,0
KRW-BTC,2022-01-10,2022-01-10T09:00:00,51672000,51999000,48897000,51246000,1.64186E+12,4.02571E+11,7955.460111,51678000,-432000,-0.008359457,14.18221734,52142000,-464000,0,464000
KRW-BTC,2022-01-11,2022-01-11T09:00:00,51255000,52493000,50408000,52307000,1.64195E+12,2.98676E+11,5812.218052,51246000,1061000,0.020704055,13.72924649,51678000,-432000,0,432000
KRW-BTC,2022-01-12,2022-01-12T09:00:00,52306000,53945000,51800000,53349000,1.64203E+12,2.96493E+11,5617.866428,52307000,1042000,0.019920852,25.05226189,51246000,1061000,1061000,0
KRW-BTC,2022-01-13,2022-01-13T09:00:00,53349000,53940000,51809000,51885000,1.64212E+12,2.89837E+11,5468.015911,53349000,-1464000,-0.027441939,34.17400135,52307000,1042000,1042000,0
KRW-BTC,2022-01-14,2022-01-14T09:00:00,51885000,52691000,51010000,52230000,1.6422E+12,2.61086E+11,5030.186536,51885000,345000,0.006649321,29.82003189,53349000,-1464000,0,1464000
KRW-BTC,2022-01-15,2022-01-15T09:00:00,52230000,52891000,51878000,52357000,1.64229E+12,1.35658E+11,2595.049411,52230000,127000,0.002431553,32.61566651,51885000,345000,345000,0
KRW-BTC,2022-01-16,2022-01-16T09:00:00,52357000,52634000,51948000,52165000,1.64238E+12,1.11417E+11,2131.428819,52357000,-192000,-0.003667131,27.02166363,52230000,127000,127000,0
KRW-BTC,2022-01-17,2022-01-17T09:00:00,52165000,52300000,50822000,51436000,1.64246E+12,1.60684E+11,3104.237631,52165000,-729000,-0.013974887,27.45757016,52357000,-192000,0,192000
KRW-BTC,2022-01-18,2022-01-18T09:00:00,51435000,51600000,50192000,51179000,1.64255E+12,1.97997E+11,3894.697552,51436000,-257000,-0.004996501,27.83408568,52165000,-729000,0,729000
KRW-BTC,2022-01-19,2022-01-19T09:00:00,51183000,51395000,49988000,50333000,1.64264E+12,2.4335E+11,4815.617545,51179000,-846000,-0.016530218,28.71704745,51436000,-257000,0,257000
KRW-BTC,2022-01-20,2022-01-20T09:00:00,50333000,52361000,49575000,49648000,1.64272E+12,3.50489E+11,6914.680876,50333000,-685000,-0.013609362,32.49477976,51179000,-846000,0,846000
KRW-BTC,2022-01-21,2022-01-21T09:00:00,49600000,50001000,44600000,45316000,1.64281E+12,6.14895E+11,13031.22269,49648000,-4332000,-0.08725427,32.27016886,50333000,-685000,0,685000
KRW-BTC,2022-01-22,2022-01-22T09:00:00,45316000,45622000,42629000,43375000,1.6429E+12,5.42097E+11,12317.48527,45316000,-1941000,-0.042832554,25.79524824,49648000,-4332000,0,4332000
KRW-BTC,2022-01-23,2022-01-23T09:00:00,43376000,44500000,42725000,44253000,1.64298E+12,2.6929E+11,6165.208729,43375000,878000,0.020242075,18.50255084,45316000,-1941000,0,1941000
KRW-BTC,2022-01-24,2022-01-24T09:00:00,44255000,45600000,40871000,44731000,1.64307E+12,4.68863E+11,10984.73258,44253000,478000,0.010801528,24.09462005,43375000,878000,878000,0
KRW-BTC,2022-01-25,2022-01-25T09:00:00,44764000,45572000,43511000,44909000,1.64316E+12,3.0848E+11,6937.037407,44731000,178000,0.003979343,27.34228281,44253000,478000,478000,0
KRW-BTC,2022-01-26,2022-01-26T09:00:00,44905000,47460000,44520000,45100000,1.64324E+12,4.65503E+11,10144.39443,44909000,191000,0.004253045,22.58781681,44731000,178000,178000,0
KRW-BTC,2022-01-27,2022-01-27T09:00:00,45100000,45844000,43786000,45809000,1.64333E+12,3.35013E+11,7488.144801,45100000,709000,0.015720621,17.37720478,44909000,191000,191000,0
KRW-BTC,2022-01-28,2022-01-28T09:00:00,45800000,46890000,45060000,46588000,1.64341E+12,2.54763E+11,5565.154275,45809000,779000,0.017005392,24.4448183,45100000,709000,709000,0
KRW-BTC,2022-01-29,2022-01-29T09:00:00,46592000,47746000,46180000,47146000,1.6435E+12,1.86286E+11,3980.167762,46588000,558000,0.011977333,27.10598929,45809000,779000,779000,0
KRW-BTC,2022-01-30,2022-01-30T09:00:00,47144000,47500000,46498000,47208000,1.64359E+12,1.35027E+11,2868.985234,47146000,62000,0.001315064,29.56951306,46588000,558000,558000,0
KRW-BTC,2022-01-31,2022-01-31T09:00:00,47208000,47647000,45624000,47266000,1.64367E+12,2.11275E+11,4554.265206,47208000,58000,0.001228605,30.36520637,47146000,62000,62000,0
KRW-BTC,2022-02-01,2022-02-01T09:00:00,47304000,48270000,46869000,47760000,1.64376E+12,1.87435E+11,3944.00161,47266000,494000,0.010451487,32.55522088,47208000,58000,58000,0
KRW-BTC,2022-02-02,2022-02-02T09:00:00,47784000,47900000,45401000,45517000,1.64385E+12,2.19281E+11,4684.820468,47760000,-2243000,-0.046963987,35.97505948,47266000,494000,494000,0
KRW-BTC,2022-02-03,2022-02-03T09:00:00,45518000,45900000,44770000,45835000,1.64393E+12,1.48839E+11,3279.737875,45517000,318000,0.006986401,32.27587222,47760000,-2243000,0,2243000
KRW-BTC,2022-02-04,2022-02-04T09:00:00,45835000,50843000,45500000,50633000,1.64402E+12,3.55675E+11,7451.464651,45835000,4798000,0.10467983,35.57757773,45517000,318000,318000,0
KRW-BTC,2022-02-05,2022-02-05T09:00:00,50613000,51488000,50216000,50788000,1.64411E+12,2.85442E+11,5618.422204,50633000,155000,0.003061245,69.42637925,45835000,4798000,4798000,0
KRW-BTC,2022-02-06,2022-02-06T09:00:00,50788000,52022000,50400000,51732000,1.64419E+12,2.06661E+11,4046.196215,50788000,944000,0.018587068,81.14967644,50633000,155000,155000,0
KRW-BTC,2022-02-07,2022-02-07T09:00:00,51678000,54110000,51084000,53511000,1.64428E+12,3.37554E+11,6414.990458,51732000,1779000,0.034388773,81.2536565,50788000,944000,944000,0
KRW-BTC,2022-02-08,2022-02-08T09:00:00,53511000,55321000,52325000,53651000,1.64436E+12,5.78845E+11,10799.76839,53511000,140000,0.002616285,83.09211518,51732000,1779000,1779000,0
KRW-BTC,2022-02-09,2022-02-09T09:00:00,53651000,54000000,52560000,53660000,1.64445E+12,2.66604E+11,5006.3985,53651000,9000,0.000167751,83.043544,53511000,140000,140000,0
KRW-BTC,2022-02-10,2022-02-10T09:00:00,53659000,55380000,52604000,53123000,1.64454E+12,4.88428E+11,9079.394423,53660000,-537000,-0.010007454,82.80699065,53651000,9000,9000,0
KRW-BTC,2022-02-11,2022-02-11T09:00:00,53040000,53364000,51300000,51882000,1.64462E+12,3.2148E+11,6124.946917,53123000,-1241000,-0.02336088,78.40608979,53660000,-537000,0,537000
KRW-BTC,2022-02-12,2022-02-12T09:00:00,51875000,52299000,50835000,51597000,1.64471E+12,2.4162E+11,4680.16805,51882000,-285000,-0.005493235,69.84853029,53123000,-1241000,0,1241000
KRW-BTC,2022-02-13,2022-02-13T09:00:00,51619000,52190000,51400000,51550000,1.6448E+12,1.41796E+11,2737.452447,51597000,-47000,-0.000910906,67.03666845,51882000,-285000,0,285000
KRW-BTC,2022-02-14,2022-02-14T09:00:00,51550000,52041000,50744000,51586000,1.64488E+12,2.18529E+11,4253.627936,51550000,36000,0.000698351,66.6385653,51597000,-47000,0,47000
KRW-BTC,2022-02-15,2022-02-15T09:00:00,51586000,53998000,51462000,53832000,1.64497E+12,2.54795E+11,4794.469464,51586000,2246000,0.043538945,66.58222018,51550000,36000,36000,0
KRW-BTC,2022-02-16,2022-02-16T09:00:00,53835000,53842000,52769000,53298000,1.64506E+12,2.44557E+11,4581.974596,53832000,-534000,-0.00991975,70.54405197,51586000,2246000,2246000,0
KRW-BTC,2022-02-17,2022-02-17T09:00:00,53298000,53540000,49203000,49376000,1.64514E+12,3.92342E+11,7615.709132,53298000,-3922000,-0.073586251,79.76891882,53832000,-534000,0,534000
KRW-BTC,2022-02-18,2022-02-18T09:00:00,49376000,50199000,48369000,49015000,1.64523E+12,2.72065E+11,5516.161741,49376000,-361000,-0.007311244,60.61896479,53298000,-3922000,0,3922000
KRW-BTC,2022-02-19,2022-02-19T09:00:00,49004000,49250000,48271000,49035000,1.64532E+12,1.4153E+11,2902.286285,49015000,20000,0.000408038,43.38836221,49376000,-361000,0,361000
KRW-BTC,2022-02-20,2022-02-20T09:00:00,49035000,49038000,46650000,47131000,1.6454E+12,2.6193E+11,5524.9488,49035000,-1904000,-0.038829408,42.75679696,49015000,20000,20000,0
KRW-BTC,2022-02-21,2022-02-21T09:00:00,47133000,48128000,45147000,45450000,1.64549E+12,3.67962E+11,7886.296025,47131000,-1681000,-0.035666546,32.38649414,49035000,-1904000,0,1904000
KRW-BTC,2022-02-22,2022-02-22T09:00:00,45450000,46693000,44746000,46474000,1.64557E+12,2.49721E+11,5478.021736,45450000,1024000,0.022530253,18.90766026,47131000,-1681000,0,1681000
KRW-BTC,2022-02-23,2022-02-23T09:00:00,46500000,47530000,45293000,45543000,1.64566E+12,2.94355E+11,6323.317763,46474000,-931000,-0.020032707,24.08463927,45450000,1024000,1024000,0
KRW-BTC,2022-02-24,2022-02-24T09:00:00,45483000,48000000,42580000,46927000,1.64575E+12,6.77428E+11,15361.05926,45543000,1384000,0.030388863,22.52014354,46474000,-931000,0,931000
KRW-BTC,2022-02-25,2022-02-25T09:00:00,46854000,48500000,46555000,47831000,1.64583E+12,3.67693E+11,7745.363798,46927000,904000,0.019263963,30.16137295,45543000,1384000,1384000,0
KRW-BTC,2022-02-26,2022-02-26T09:00:00,47830000,49010000,47200000,47809000,1.64592E+12,2.11662E+11,4412.336896,47831000,-22000,-0.000459953,36.74324236,46927000,904000,904000,0
KRW-BTC,2022-02-27,2022-02-27T09:00:00,47850000,48576000,45695000,46358000,1.64601E+12,2.7826E+11,5879.515341,47809000,-1451000,-0.030349934,37.38678743,47831000,-22000,0,22000
KRW-BTC,2022-02-28,2022-02-28T09:00:00,46363000,53089000,46086000,52332000,1.64609E+12,5.10345E+11,10346.17939,46358000,5974000,0.128866647,34.19001218,47809000,-1451000,0,1451000
KRW-BTC,2022-03-01,2022-03-01T09:00:00,52332000,54777000,52004000,53790000,1.64618E+12,5.80017E+11,10899.50681,52332000,1458000,0.027860582,51.66830665,46358000,5974000,5974000,0
KRW-BTC,2022-03-02,2022-03-02T09:00:00,53789000,54829000,52789000,53359000,1.64627E+12,4.10042E+11,7651.796389,53790000,-431000,-0.008012642,49.90264256,52332000,1458000,1458000,0
KRW-BTC,2022-03-03,2022-03-03T09:00:00,53359000,53710000,51219000,51842000,1.64635E+12,2.98404E+11,5670.325737,53359000,-1517000,-0.028430068,50.14207854,53790000,-431000,0,431000
KRW-BTC,2022-03-04,2022-03-04T09:00:00,51875000,51952000,48071000,48450000,1.64644E+12,4.1165E+11,8201.726987,51842000,-3392000,-0.065429575,56.46836638,53359000,-1517000,0,1517000
KRW-BTC,2022-03-05,2022-03-05T09:00:00,48450000,48866000,47814000,48605000,1.64652E+12,2.38916E+11,4946.117104,48450000,155000,0.003199174,48.72131444,51842000,-3392000,0,3392000
KRW-BTC,2022-03-06,2022-03-06T09:00:00,48610000,49024000,47260000,47745000,1.64661E+12,2.31568E+11,4817.157461,48605000,-860000,-0.017693653,49.03275148,48450000,155000,155000,0
KRW-BTC,2022-03-07,2022-03-07T09:00:00,47782000,48890000,46525000,47415000,1.6467E+12,3.27978E+11,6885.298741,47745000,-330000,-0.006911719,51.44920695,48605000,-860000,0,860000
KRW-BTC,2022-03-08,2022-03-08T09:00:00,47364000,48800000,47290000,48213000,1.64678E+12,2.29182E+11,4764.739534,47415000,798000,0.016830117,54.95386477,47745000,-330000,0,330000
KRW-BTC,2022-03-09,2022-03-09T09:00:00,48213000,52300000,48153000,51570000,1.64687E+12,4.79358E+11,9356.854304,48213000,3357000,0.069628523,54.43464069,47415000,798000,798000,0
KRW-BTC,2022-03-10,2022-03-10T09:00:00,51571000,51844000,48291000,48917000,1.64696E+12,4.94329E+11,10019.04392,51570000,-2653000,-0.051444638,63.67721146,48213000,3357000,3357000,0
KRW-BTC,2022-03-11,2022-03-11T09:00:00,48931000,49941000,47802000,48315000,1.64704E+12,3.45465E+11,7089.912741,48917000,-602000,-0.01230656,54.27001974,51570000,-2653000,0,2653000
KRW-BTC,2022-03-12,2022-03-12T09:00:00,48314000,49098000,48202000,48500000,1.64713E+12,1.31419E+11,2697.302198,48315000,185000,0.003829039,51.05217391,48917000,-602000,0,602000
KRW-BTC,2022-03-13,2022-03-13T09:00:00,48500000,48904000,47310000,47510000,1.64722E+12,1.98434E+11,4109.285912,48500000,-990000,-0.020412371,51.49160299,48315000,185000,185000,0
KRW-BTC,2022-03-14,2022-03-14T09:00:00,47500000,49515000,47186000,49171000,1.6473E+12,3.06727E+11,6352.923551,47510000,1661000,0.034961061,52.53722139,48500000,-990000,0,990000
KRW-BTC,2022-03-15,2022-03-15T09:00:00,49212000,49383000,47781000,48640000,1.64739E+12,2.71852E+11,5609.768747,49171000,-531000,-0.010799048,41.40518788,47510000,1661000,1661000,0
KRW-BTC,2022-03-16,2022-03-16T09:00:00,48609000,51307000,48402000,50389000,1.64748E+12,6.28483E+11,12621.47056,48640000,1749000,0.035958059,35.25369373,49171000,-531000,0,531000
KRW-BTC,2022-03-17,2022-03-17T09:00:00,50392000,51099000,49647000,50069000,1.64756E+12,3.23349E+11,6441.900307,50389000,-320000,-0.006350592,42.09265176,48640000,1749000,1749000,0
KRW-BTC,2022-03-18,2022-03-18T09:00:00,50069000,51220000,49423000,50770000,1.64765E+12,3.1912E+11,6364.186934,50069000,701000,0.014000679,44.95819826,50389000,-320000,0,320000
KRW-BTC,2022-03-19,2022-03-19T09:00:00,50736000,51300000,50615000,51245000,1.64773E+12,2.55391E+11,5016.392418,50770000,475000,0.009355919,57.78941714,50069000,701000,701000,0
KRW-BTC,2022-03-20,2022-03-20T09:00:00,51245000,51350000,50001000,50462000,1.64782E+12,2.05914E+11,4050.028652,51245000,-783000,-0.01527954,58.67735998,50770000,475000,475000,0
KRW-BTC,2022-03-21,2022-03-21T09:00:00,50471000,50756000,49832000,50128000,1.64791E+12,2.21912E+11,4418.71583,50462000,-334000,-0.006618842,58.97588371,51245000,-783000,0,783000
KRW-BTC,2022-03-22,2022-03-22T09:00:00,50128000,52396000,50013000,51704000,1.64799E+12,4.33481E+11,8395.367481,50128000,1576000,0.031439515,58.96030121,50462000,-334000,0,334000
KRW-BTC,2022-03-23,2022-03-23T09:00:00,51689000,52232000,51118000,52138000,1.64808E+12,2.73158E+11,5293.402954,51704000,434000,0.008393935,60.96626249,50128000,1576000,1576000,0
KRW-BTC,2022-03-24,2022-03-24T09:00:00,52138000,53416000,51800000,52966000,1.64817E+12,3.82789E+11,7289.941854,52138000,828000,0.015880931,52.18562413,51704000,434000,434000,0
KRW-BTC,2022-03-25,2022-03-25T09:00:00,52907000,54450000,52700000,53791000,1.64825E+12,3.03815E+11,5670.827515,52966000,825000,0.01557603,68.12606321,52138000,828000,828000,0
KRW-BTC,2022-03-26,2022-03-26T09:00:00,53836000,54241000,53402000,53902000,1.64834E+12,1.79589E+11,3333.058744,53791000,111000,0.002063542,74.03441011,52966000,825000,825000,0
KRW-BTC,2022-03-27,2022-03-27T09:00:00,53888000,56201000,53674000,55949000,1.64843E+12,2.92027E+11,5341.023716,53902000,2047000,0.037976327,73.8646404,53791000,111000,111000,0
KRW-BTC,2022-03-28,2022-03-28T09:00:00,55936000,57678000,55827000,56914000,1.64851E+12,3.61569E+11,6374.435146,55949000,965000,0.017247851,84.0969697,53902000,2047000,2047000,0
KRW-BTC,2022-03-29,2022-03-29T09:00:00,56900000,57540000,56390000,56985000,1.6486E+12,3.78907E+11,6629.178471,56914000,71000,0.001247496,83.14924223,55949000,965000,965000,0
KRW-BTC,2022-03-30,2022-03-30T09:00:00,56985000,57100000,56015000,56620000,1.64868E+12,2.34529E+11,4136.114493,56985000,-365000,-0.006405194,87.19137178,56914000,71000,71000,0
KRW-BTC,2022-03-31,2022-03-31T09:00:00,56594000,57227000,55230000,55352000,1.64877E+12,2.90425E+11,5141.563266,56620000,-1268000,-0.022394914,81.67768175,56985000,-365000,0,365000
KRW-BTC,2022-04-01,2022-04-01T09:00:00,55331000,56790000,54246000,56369000,1.64886E+12,3.7377E+11,6752.645356,55352000,1017000,0.01837332,74.49689326,56620000,-1268000,0,1268000
KRW-BTC,2022-04-02,2022-04-02T09:00:00,56326000,57350000,55831000,56050000,1.64894E+12,2.19804E+11,3882.902028,56369000,-319000,-0.005659139,75.22299306,55352000,1017000,1017000,0
KRW-BTC,2022-04-03,2022-04-03T09:00:00,56006000,57500000,55830000,56639000,1.64903E+12,2.16198E+11,3818.056037,56050000,589000,0.010508475,71.95467422,56369000,-319000,0,319000
KRW-BTC,2022-04-04,2022-04-04T09:00:00,56596000,57300000,55510000,57055000,1.64912E+12,3.33785E+11,5916.740186,56639000,416000,0.007344762,78.73290539,56050000,589000,589000,0
KRW-BTC,2022-04-05,2022-04-05T09:00:00,57069000,57645000,56070000,56155000,1.6492E+12,2.62969E+11,4627.208651,57055000,-900000,-0.015774253,81.97765673,56639000,416000,416000,0
KRW-BTC,2022-04-06,2022-04-06T09:00:00,56195000,56323000,53034000,53072000,1.64929E+12,3.71678E+11,6776.518826,56155000,-3083000,-0.054901612,71.91531265,57055000,-900000,0,900000
KRW-BTC,2022-04-07,2022-04-07T09:00:00,53072000,54340000,52754000,53814000,1.64938E+12,2.87116E+11,5354.289371,53072000,742000,0.013981007,53.64729772,56155000,-3083000,0,3083000
KRW-BTC,2022-04-08,2022-04-08T09:00:00,53813000,54700000,52798000,52934000,1.64946E+12,2.7608E+11,5123.922396,53814000,-880000,-0.016352622,53.33385752,53072000,742000,742000,0
KRW-BTC,2022-04-09,2022-04-09T09:00:00,52934000,53355000,52754000,53258000,1.64955E+12,1.19523E+11,2253.816753,52934000,324000,0.00612083,46.64526736,53814000,-880000,0,880000
KRW-BTC,2022-04-10,2022-04-10T09:00:00,53295000,53950000,52462000,52819000,1.64964E+12,1.21721E+11,2289.320776,53258000,-439000,-0.008242893,47.52040659,52934000,324000,324000,0
KRW-BTC,2022-04-11,2022-04-11T09:00:00,52799000,53060000,50010000,50050000,1.64972E+12,2.77984E+11,5382.92605,52819000,-2769000,-0.052424317,36.24538583,53258000,-439000,0,439000
KRW-BTC,2022-04-12,2022-04-12T09:00:00,50050000,51195000,49608000,50577000,1.64981E+12,2.38179E+11,4730.164656,50050000,527000,0.010529471,23.96449704,52819000,-2769000,0,2769000
KRW-BTC,2022-04-13,2022-04-13T09:00:00,50577000,51947000,49936000,51700000,1.64989E+12,1.69541E+11,3335.413278,50577000,1123000,0.022203769,26.50681918,50050000,527000,527000,0
KRW-BTC,2022-04-14,2022-04-14T09:00:00,51645000,51942000,50000000,50245000,1.64998E+12,1.65648E+11,3240.368356,51700000,-1455000,-0.028143134,32.91191998,50577000,1123000,1123000,0
KRW-BTC,2022-04-15,2022-04-15T09:00:00,50275000,51286000,50079000,50850000,1.65007E+12,1.13924E+11,2259.858439,50245000,605000,0.012040999,32.48988548,51700000,-1455000,0,1455000
KRW-BTC,2022-04-16,2022-04-16T09:00:00,50807000,51100000,50251000,50567000,1.65015E+12,65131786308,1285.878108,50850000,-283000,-0.005565388,30.52713288,50245000,605000,605000,0
KRW-BTC,2022-04-17,2022-04-17T09:00:00,50567000,50698000,49851000,49962000,1.65024E+12,82769167198,1643.271089,50567000,-605000,-0.011964325,30.6048815,50850000,-283000,0,283000
KRW-BTC,2022-04-18,2022-04-18T09:00:00,49962000,51290000,48626000,50839000,1.65033E+12,1.97866E+11,3977.644332,49962000,877000,0.017553341,26.4080277,50567000,-605000,0,605000
KRW-BTC,2022-04-19,2022-04-19T09:00:00,50768000,51904000,50550000,51458000,1.65041E+12,1.44034E+11,2813.977539,50839000,619000,0.012175692,28.72981111,49962000,877000,877000,0
KRW-BTC,2022-04-20,2022-04-20T09:00:00,51459000,52326000,51015000,51388000,1.6505E+12,1.44037E+11,2789.563537,51458000,-70000,-0.001360333,33.61244854,50839000,619000,619000,0
KRW-BTC,2022-04-21,2022-04-21T09:00:00,51436000,53075000,50250000,50805000,1.65059E+12,2.35868E+11,4540.571121,51388000,-583000,-0.011345061,42.56052306,51458000,-70000,0,70000
KRW-BTC,2022-04-22,2022-04-22T09:00:00,50805000,51000000,49526000,49937000,1.65067E+12,1.66518E+11,3309.37627,50805000,-868000,-0.017084933,36.5176091,51388000,-583000,0,583000
KRW-BTC,2022-04-23,2022-04-23T09:00:00,49937000,50290000,49466000,49742000,1.65076E+12,94878858639,1905.146898,49937000,-195000,-0.00390492,36.55692114,50805000,-868000,0,868000
KRW-BTC,2022-04-24,2022-04-24T09:00:00,49723000,50211000,49300000,49620000,1.65084E+12,82647094726,1658.617408,49742000,-122000,-0.002452656,34.04429116,49937000,-195000,0,195000
KRW-BTC,2022-04-25,2022-04-25T09:00:00,49620000,50993000,48600000,50614000,1.65093E+12,2.08006E+11,4209.037602,49620000,994000,0.020032245,35.0527988,49742000,-122000,0,122000
KRW-BTC,2022-04-26,2022-04-26T09:00:00,50614000,51193000,48300000,48777000,1.65102E+12,2.07571E+11,4171.124098,50614000,-1837000,-0.036294306,53.15930988,49620000,994000,994000,0
KRW-BTC,2022-04-27,2022-04-27T09:00:00,48718000,50100000,48568000,49954000,1.6511E+12,1.36962E+11,2774.396468,48777000,1177000,0.024130225,41.20750293,50614000,-1837000,0,1837000
KRW-BTC,2022-04-28,2022-04-28T09:00:00,49954000,51299000,49666000,50580000,1.65119E+12,1.59374E+11,3157.489825,49954000,626000,0.012531529,41.51603499,48777000,1177000,1177000,0
KRW-BTC,2022-04-29,2022-04-29T09:00:00,50580000,50829000,49412000,49731000,1.65128E+12,1.42344E+11,2848.957459,50580000,-849000,-0.016785291,51.77042596,49954000,626000,626000,0
KRW-BTC,2022-04-30,2022-04-30T09:00:00,49731000,49953000,49243000,49283000,1.65136E+12,1.03248E+11,2078.698534,49731000,-448000,-0.009008466,44.23493045,50580000,-849000,0,849000
KRW-BTC,2022-05-01,2022-05-01T09:00:00,49283000,49620000,48500000,49383000,1.65145E+12,1.41631E+11,2882.99454,49283000,100000,0.002029097,43.49544073,49731000,-448000,0,448000
KRW-BTC,2022-05-02,2022-05-02T09:00:00,49383000,50210000,49110000,49520000,1.65154E+12,1.29932E+11,2614.56356,49383000,137000,0.002774234,46.90870262,49283000,100000,100000,0
KRW-BTC,2022-05-03,2022-05-03T09:00:00,49501000,49678000,48638000,48777000,1.65162E+12,1.35667E+11,2755.309315,49520000,-743000,-0.015004039,42.35362319,49383000,137000,137000,0
KRW-BTC,2022-05-04,2022-05-04T09:00:00,48772000,50999000,48722000,50616000,1.65171E+12,1.9473E+11,3904.11622,48777000,1839000,0.037702196,34.67824894,49520000,-743000,0,743000
KRW-BTC,2022-05-05,2022-05-05T09:00:00,50631000,50832000,47048000,47647000,1.6518E+12,3.04845E+11,6259.7612,50616000,-2969000,-0.058657342,46.33010078,48777000,1839000,1839000,0
KRW-BTC,2022-05-06,2022-05-06T09:00:00,47650000,47800000,46210000,47031000,1.65188E+12,1.91195E+11,4073.145828,47647000,-616000,-0.012928411,37.76348419,50616000,-2969000,0,2969000
KRW-BTC,2022-05-07,2022-05-07T09:00:00,47030000,47130000,46054000,46507000,1.65197E+12,80649441506,1727.395058,47031000,-524000,-0.011141588,38.5156497,47647000,-616000,0,616000
KRW-BTC,2022-05-08,2022-05-08T09:00:00,46507000,46515000,44624000,44770000,1.65205E+12,1.86618E+11,4109.81944,46507000,-1737000,-0.037349216,37.53948078,47031000,-524000,0,524000
KRW-BTC,2022-05-09,2022-05-09T09:00:00,44763000,45037000,40719000,41002000,1.65214E+12,3.56444E+11,8307.106093,44770000,-3768000,-0.084163502,33.38585914,46507000,-1737000,0,1737000
KRW-BTC,2022-05-10,2022-05-10T09:00:00,41000000,43110000,40150000,41046000,1.65223E+12,5.01967E+11,12076.37493,41002000,44000,0.001073118,22.33160622,44770000,-3768000,0,3768000
KRW-BTC,2022-05-11,2022-05-11T09:00:00,41044000,43980000,39088000,40290000,1.65231E+12,1.32877E+12,31967.29719,41046000,-756000,-0.01841836,25.18456699,41002000,44000,44000,0
KRW-BTC,2022-05-12,2022-05-12T09:00:00,40263000,41178000,37000000,39243000,1.6524E+12,9.11518E+11,23389.06343,40290000,-1047000,-0.025986597,18.118237,41046000,-756000,0,756000
KRW-BTC,2022-05-13,2022-05-13T09:00:00,39246000,41324000,38777000,39270000,1.65249E+12,4.98374E+11,12398.9188,39243000,27000,0.000688021,13.60980933,40290000,-1047000,0,1047000
KRW-BTC,2022-05-14,2022-05-14T09:00:00,39270000,40243000,38400000,39967000,1.65257E+12,2.17009E+11,5512.19562,39270000,697000,0.017748918,14.55099966,39243000,27000,27000,0
KRW-BTC,2022-05-15,2022-05-15T09:00:00,39967000,41000000,39270000,40906000,1.65266E+12,1.70673E+11,4277.655034,39967000,939000,0.023494383,18.95494535,39270000,697000,697000,0
KRW-BTC,2022-05-16,2022-05-16T09:00:00,40902000,40940000,38620000,39256000,1.65275E+12,2.2437E+11,5678.833853,40906000,-1650000,-0.040336381,23.24685981,39967000,939000,939000,0
KRW-BTC,2022-05-17,2022-05-17T09:00:00,39260000,39900000,38416000,39259000,1.65283E+12,2.10536E+11,5356.753182,39256000,3000,7.64E-05,20.43097488,40906000,-1650000,0,1650000
KRW-BTC,2022-05-18,2022-05-18T09:00:00,39260000,39464000,37001000,37099000,1.65292E+12,2.43087E+11,6367.45223,39259000,-2160000,-0.055019231,21.35893115,39256000,3000,3000,0
KRW-BTC,2022-05-19,2022-05-19T09:00:00,37100000,39085000,37000000,38780000,1.653E+12,2.42975E+11,6407.341868,37099000,1681000,0.045311194,10.096239,39259000,-2160000,0,2160000
KRW-BTC,2022-05-20,2022-05-20T09:00:00,38781000,39298000,37267000,37762000,1.65309E+12,2.2527E+11,5865.610376,38780000,-1018000,-0.026250645,21.66911624,37099000,1681000,1681000,0
KRW-BTC,2022-05-21,2022-05-21T09:00:00,37798000,38253000,37558000,38037000,1.65318E+12,1.06779E+11,2813.64815,37762000,275000,0.007282453,21.12640957,38780000,-1018000,0,1018000
KRW-BTC,2022-05-22,2022-05-22T09:00:00,38037000,39150000,37886000,38933000,1.65326E+12,1.28578E+11,3336.520707,38037000,896000,0.023556011,23.19959499,37762000,275000,275000,0
KRW-BTC,2022-05-23,2022-05-23T09:00:00,38933000,39220000,37209000,37436000,1.65335E+12,1.90335E+11,4947.221049,38933000,-1497000,-0.038450672,30.49261413,38037000,896000,896000,0
KRW-BTC,2022-05-24,2022-05-24T09:00:00,37436000,38000000,36725000,37827000,1.65344E+12,1.42911E+11,3823.785368,37436000,391000,0.010444492,35.94956659,38933000,-1497000,0,1497000
KRW-BTC,2022-05-25,2022-05-25T09:00:00,37827000,38360000,37558000,37935000,1.65352E+12,1.47138E+11,3871.091337,37827000,108000,0.002855104,37.65436834,37436000,391000,391000,0
KRW-BTC,2022-05-26,2022-05-26T09:00:00,37937000,38230000,36394000,37662000,1.65361E+12,1.95505E+11,5202.304333,37935000,-273000,-0.00719652,40.49560094,37827000,108000,108000,0
KRW-BTC,2022-05-27,2022-05-27T09:00:00,37662000,37889000,36413000,36837000,1.6537E+12,1.62037E+11,4373.885371,37662000,-825000,-0.021905369,43.1941455,37935000,-273000,0,273000
KRW-BTC,2022-05-28,2022-05-28T09:00:00,36862000,37373000,36613000,37034000,1.65378E+12,71361163244,1931.845973,36837000,197000,0.005347884,40.19979054,37662000,-825000,0,825000
KRW-BTC,2022-05-29,2022-05-29T09:00:00,37033000,37620000,36825000,37380000,1.65387E+12,63691223301,1712.650146,37034000,346000,0.009342766,37.68991858,36837000,197000,197000,0
KRW-BTC,2022-05-30,2022-05-30T09:00:00,37415000,39989000,37230000,39550000,1.65396E+12,2.11275E+11,5467.460037,37380000,2170000,0.058052435,34.42579505,37034000,346000,346000,0
KRW-BTC,2022-05-31,2022-05-31T09:00:00,39527000,40600000,39300000,39923000,1.65404E+12,2.56308E+11,6442.979981,39550000,373000,0.0094311,51.24155405,37380000,2170000,2170000,0
KRW-BTC,2022-06-01,2022-06-01T09:00:00,39927000,40150000,37500000,37880000,1.65413E+12,2.45744E+11,6304.814273,39923000,-2043000,-0.051173509,52.71908272,39550000,373000,373000,0
KRW-BTC,2022-06-02,2022-06-02T09:00:00,37880000,38680000,37558000,38392000,1.65421E+12,1.10237E+11,2899.345673,37880000,512000,0.013516368,53.22914083,39923000,-2043000,0,2043000
KRW-BTC,2022-06-03,2022-06-03T09:00:00,38393000,38630000,37378000,37851000,1.6543E+12,1.37239E+11,3606.94747,38392000,-541000,-0.014091477,48.22409374,37880000,512000,512000,0
KRW-BTC,2022-06-04,2022-06-04T09:00:00,37852000,38100000,37666000,37916000,1.65439E+12,53025106658,1401.312285,37851000,65000,0.00171726,50.42595961,38392000,-541000,0,541000
KRW-BTC,2022-06-05,2022-06-05T09:00:00,37916000,38300000,37608000,37972000,1.65447E+12,49985999685,1320.221687,37916000,56000,0.001476949,49.40900654,37851000,65000,65000,0
KRW-BTC,2022-06-06,2022-06-06T09:00:00,37974000,39952000,37966000,39532000,1.65456E+12,1.72042E+11,4372.224579,37972000,1560000,0.041082903,44.88666596,37916000,56000,56000,0
KRW-BTC,2022-06-07,2022-06-07T09:00:00,39532000,39797000,37500000,39398000,1.65465E+12,3.0325E+11,7886.332468,39532000,-134000,-0.003389659,61.0782241,37972000,1560000,1560000,0
KRW-BTC,2022-06-08,2022-06-08T09:00:00,39366000,39599000,38128000,38581000,1.65473E+12,1.9935E+11,5152.829444,39398000,-817000,-0.020737093,58.53526024,39532000,-134000,0,134000
KRW-BTC,2022-06-09,2022-06-09T09:00:00,38581000,38800000,38150000,38256000,1.65482E+12,1.13235E+11,2945.150783,38581000,-325000,-0.008423836,53.25867635,39398000,-817000,0,817000
KRW-BTC,2022-06-10,2022-06-10T09:00:00,38265000,38850000,37470000,37611000,1.65491E+12,1.68289E+11,4429.214789,38256000,-645000,-0.0168601,52.98073063,38581000,-325000,0,325000
KRW-BTC,2022-06-11,2022-06-11T09:00:00,37613000,37990000,36680000,37058000,1.65499E+12,1.67988E+11,4509.661188,37611000,-553000,-0.014703145,53.95543745,38256000,-645000,0,645000
KRW-BTC,2022-06-12,2022-06-12T09:00:00,37061000,37157000,34700000,34718000,1.65508E+12,2.1986E+11,6146.331874,37058000,-2340000,-0.06314426,50.1183432,37611000,-553000,0,553000
KRW-BTC,2022-06-13,2022-06-13T09:00:00,34718000,35050000,28960000,29372000,1.65516E+12,6.68026E+11,21092.0642,34718000,-5346000,-0.153983524,39.03082248,37058000,-2340000,0,2340000
KRW-BTC,2022-06-14,2022-06-14T09:00:00,29373000,30205000,27412000,28829000,1.65525E+12,5.61773E+11,19487.81541,29372000,-543000,-0.018486994,16.76028739,34718000,-5346000,0,5346000
KRW-BTC,2022-06-15,2022-06-15T09:00:00,28828000,29566000,26694000,29253000,1.65534E+12,5.59001E+11,20040.69089,28829000,424000,0.014707413,14.16666667,29372000,-543000,0,543000
KRW-BTC,2022-06-16,2022-06-16T09:00:00,29235000,29622000,26718000,26898000,1.65542E+12,3.05926E+11,10897.12712,29253000,-2355000,-0.080504564,18.88031167,28829000,424000,424000,0
KRW-BTC,2022-06-17,2022-06-17T09:00:00,26900000,27920000,26573000,27010000,1.65551E+12,2.24343E+11,8254.74721,26898000,112000,0.004163878,13.40422822,29253000,-2355000,0,2355000
KRW-BTC,2022-06-18,2022-06-18T09:00:00,27010000,27345000,24000000,25093000,1.6556E+12,4.33108E+11,17021.37138,27010000,-1917000,-0.070973713,14.51391162,26898000,112000,112000,0
KRW-BTC,2022-06-19,2022-06-19T09:00:00,25096000,26943000,23800000,26642000,1.65568E+12,3.81029E+11,15039.09542,25093000,1549000,0.061730363,12.56495592,27010000,-1917000,0,1917000
KRW-BTC,2022-06-20,2022-06-20T09:00:00,26666000,27184000,25599000,26643000,1.65577E+12,3.29953E+11,12451.16444,26642000,1000,3.75E-05,19.57572503,25093000,1549000,1549000,0
KRW-BTC,2022-06-21,2022-06-21T09:00:00,26643000,27970000,26476000,26967000,1.65586E+12,2.7847E+11,10207.59721,26643000,324000,0.012160793,12.2267159,26642000,1000,1000,0
KRW-BTC,2022-06-22,2022-06-22T09:00:00,26967000,27160000,25950000,26193000,1.65594E+12,2.09448E+11,7880.698109,26967000,-774000,-0.028701747,13.97020463,26643000,324000,324000,0
KRW-BTC,2022-06-23,2022-06-23T09:00:00,26180000,27489000,26105000,27419000,1.65603E+12,3.13542E+11,11674.89802,26193000,1226000,0.046806399,14.0051139,26967000,-774000,0,774000
KRW-BTC,2022-06-24,2022-06-24T09:00:00,27419000,27900000,26975000,27597000,1.65612E+12,3.67521E+11,13388.93224,27419000,178000,0.006491849,20.07841405,26193000,1226000,1226000,0
KRW-BTC,2022-06-25,2022-06-25T09:00:00,27592000,27989000,27258000,27832000,1.6562E+12,1.72244E+11,6225.328283,27597000,235000,0.008515418,21.61886407,27419000,178000,178000,0
KRW-BTC,2022-06-26,2022-06-26T09:00:00,27837000,28350000,27415000,27460000,1.65629E+12,1.51631E+11,5447.101318,27832000,-372000,-0.01336591,23.37220042,27597000,235000,235000,0
KRW-BTC,2022-06-27,2022-06-27T09:00:00,27475000,27850000,26800000,27039000,1.65637E+12,1.57292E+11,5752.807181,27460000,-421000,-0.015331391,26.36754363,27832000,-372000,0,372000
KRW-BTC,2022-06-28,2022-06-28T09:00:00,27033000,27456000,26470000,26547000,1.65646E+12,1.45709E+11,5406.36167,27039000,-492000,-0.018195939,38.81698782,27460000,-421000,0,421000
KRW-BTC,2022-06-29,2022-06-29T09:00:00,26553000,26800000,26163000,26548000,1.65655E+12,2.43859E+11,9223.202521,26547000,1000,3.77E-05,39.00770713,27039000,-492000,0,492000
KRW-BTC,2022-06-30,2022-06-30T09:00:00,26572000,26609000,24776000,26003000,1.65663E+12,2.92543E+11,11478.34481,26548000,-545000,-0.020528853,36.41659134,26547000,1000,1000,0
KRW-BTC,2022-07-01,2022-07-01T09:00:00,25999000,27110000,25100000,25556000,1.65672E+12,2.76373E+11,10667.06531,26003000,-447000,-0.017190324,44.50718056,26548000,-545000,0,545000
KRW-BTC,2022-07-02,2022-07-02T09:00:00,25576000,25700000,25180000,25463000,1.65681E+12,91226992258,3585.127254,25556000,-93000,-0.003639067,41.42890828,26003000,-447000,0,447000
KRW-BTC,2022-07-03,2022-07-03T09:00:00,25465000,25870000,25000000,25422000,1.65689E+12,1.01636E+11,4004.472955,25463000,-41000,-0.00161018,52.7786122,25556000,-93000,0,93000
KRW-BTC,2022-07-04,2022-07-04T09:00:00,25454000,26560000,25150000,26399000,1.65698E+12,1.61103E+11,6263.456445,25422000,977000,0.03843128,38.15533981,25463000,-41000,0,41000
KRW-BTC,2022-07-05,2022-07-05T09:00:00,26399000,27269000,25580000,26548000,1.65707E+12,2.21922E+11,8426.868583,26399000,149000,0.005644153,48.00848841,25422000,977000,977000,0
KRW-BTC,2022-07-06,2022-07-06T09:00:00,26523000,27084000,26131000,26954000,1.65715E+12,1.57481E+11,5929.702977,26548000,406000,0.015293054,46.47958326,26399000,149000,149000,0
KRW-BTC,2022-07-07,2022-07-07T09:00:00,26953000,28347000,26600000,28115000,1.65724E+12,2.39027E+11,8756.639876,26954000,1161000,0.043073384,56.81533226,26548000,406000,406000,0
KRW-BTC,2022-07-08,2022-07-08T09:00:00,28129000,29084000,27800000,28241000,1.65732E+12,3.07025E+11,10799.53961,28115000,126000,0.004481594,56.30663284,26954000,1161000,1161000,0
KRW-BTC,2022-07-09,2022-07-09T09:00:00,28241000,28600000,27915000,28200000,1.65741E+12,1.28524E+11,4557.639274,28241000,-41000,-0.00145179,55.89096231,28115000,126000,126000,0
KRW-BTC,2022-07-10,2022-07-10T09:00:00,28199000,28222000,27181000,27317000,1.6575E+12,1.38734E+11,5010.69691,28200000,-883000,-0.031312057,53.49013657,28241000,-41000,0,41000
KRW-BTC,2022-07-11,2022-07-11T09:00:00,27317000,27327000,26400000,26460000,1.65758E+12,1.56475E+11,5812.765697,27317000,-857000,-0.031372406,48.7636175,28200000,-883000,0,883000
KRW-BTC,2022-07-12,2022-07-12T09:00:00,26474000,26565000,25650000,25723000,1.65767E+12,1.35295E+11,5167.365294,26460000,-737000,-0.027853364,45.34491076,27317000,-857000,0,857000
KRW-BTC,2022-07-13,2022-07-13T09:00:00,25723000,26759000,25200000,26611000,1.65776E+12,2.16442E+11,8364.967594,25723000,888000,0.034521634,43.62623762,26460000,-737000,0,737000
KRW-BTC,2022-07-14,2022-07-14T09:00:00,26604000,27500000,26103000,27135000,1.65784E+12,1.86299E+11,6982.831754,26611000,524000,0.019691105,50.42851313,25723000,888000,888000,0
KRW-BTC,2022-07-15,2022-07-15T09:00:00,27140000,27899000,26914000,27518000,1.65793E+12,1.71512E+11,6257.933136,27135000,383000,0.014114612,57.72169168,26611000,524000,524000,0
KRW-BTC,2022-07-16,2022-07-16T09:00:00,27496000,28387000,27114000,27857000,1.65802E+12,1.47798E+11,5336.108806,27518000,339000,0.012319209,63.50123865,27135000,383000,383000,0
KRW-BTC,2022-07-17,2022-07-17T09:00:00,27856000,28481000,27453000,27505000,1.6581E+12,1.7777E+11,6347.366046,27857000,-352000,-0.012635962,65.93450479,27518000,339000,339000,0
KRW-BTC,2022-07-18,2022-07-18T09:00:00,27505000,29613000,27450000,29322000,1.65819E+12,3.98301E+11,13859.74528,27505000,1817000,0.066060716,63.31330692,27857000,-352000,0,352000
KRW-BTC,2022-07-19,2022-07-19T09:00:00,29322000,31050000,28476000,30660000,1.65828E+12,4.32242E+11,14595.94786,29322000,1338000,0.045631267,66.8705991,27505000,1817000,1817000,0
KRW-BTC,2022-07-20,2022-07-20T09:00:00,30646000,31831000,30128000,30505000,1.65836E+12,3.85273E+11,12434.44376,30660000,-155000,-0.005055447,70.86885911,29322000,1338000,1338000,0
KRW-BTC,2022-07-21,2022-07-21T09:00:00,30500000,30849000,29621000,30415000,1.65845E+12,3.22028E+11,10664.60764,30505000,-90000,-0.002950336,68.49286533,30660000,-155000,0,155000
KRW-BTC,2022-07-22,2022-07-22T09:00:00,30415000,31201000,29874000,30080000,1.65853E+12,2.32744E+11,7607.908909,30415000,-335000,-0.011014302,63.48182884,30505000,-90000,0,90000
KRW-BTC,2022-07-23,2022-07-23T09:00:00,30077000,30272000,29214000,29722000,1.65862E+12,1.69985E+11,5699.598361,30080000,-358000,-0.011901596,60.52179883,30415000,-335000,0,335000
KRW-BTC,2022-07-24,2022-07-24T09:00:00,29704000,30195000,29498000,29818000,1.65871E+12,1.54939E+11,5186.691596,29722000,96000,0.003229931,58.40326855,30080000,-358000,0,358000
KRW-BTC,2022-07-25,2022-07-25T09:00:00,29818000,29938000,28500000,28555000,1.65879E+12,2.38652E+11,8196.410471,29818000,-1263000,-0.042356966,65.12274761,29722000,96000,96000,0
KRW-BTC,2022-07-26,2022-07-26T09:00:00,28555000,28633000,27716000,28401000,1.65888E+12,1.79987E+11,6394.874999,28555000,-154000,-0.005393101,62.07492795,29818000,-1263000,0,1263000
KRW-BTC,2022-07-27,2022-07-27T09:00:00,28401000,30492000,28165000,30202000,1.65897E+12,2.42209E+11,8326.594453,28401000,1801000,0.06341326,66.54720712,28555000,-154000,0,154000
KRW-BTC,2022-07-28,2022-07-28T09:00:00,30200000,31573000,29850000,31217000,1.65905E+12,3.24879E+11,10610.58966,30202000,1015000,0.033607046,69.93892282,28401000,1801000,1801000,0
KRW-BTC,2022-07-29,2022-07-29T09:00:00,31217000,31990000,30965000,31404000,1.65914E+12,3.06877E+11,9751.911398,31217000,187000,0.005990326,71.49326032,30202000,1015000,1015000,0
KRW-BTC,2022-07-30,2022-07-30T09:00:00,31402000,32500000,31171000,31281000,1.65923E+12,2.34009E+11,7360.059756,31404000,-123000,-0.003916699,70.89247312,31217000,187000,187000,0
KRW-BTC,2022-07-31,2022-07-31T09:00:00,31270000,31775000,30714000,30751000,1.65931E+12,2.21747E+11,7085.408944,31281000,-530000,-0.016943192,68.84632321,31404000,-123000,0,123000
KRW-BTC,2022-08-01,2022-08-01T09:00:00,30750000,31099000,30392000,30851000,1.6594E+12,2.0397E+11,6632.833037,30751000,100000,0.003251927,67.52321313,31281000,-530000,0,530000
KRW-BTC,2022-08-02,2022-08-02T09:00:00,30851000,31141000,30246000,30754000,1.65948E+12,2.32698E+11,7603.47583,30851000,-97000,-0.003144144,60.1325381,30751000,100000,100000,0
KRW-BTC,2022-08-03,2022-08-03T09:00:00,30754000,31467000,30509000,30708000,1.65957E+12,1.8872E+11,6104.358089,30754000,-46000,-0.00149574,50.74555838,30851000,-97000,0,97000
KRW-BTC,2022-08-04,2022-08-04T09:00:00,30708000,30980000,30159000,30315000,1.65966E+12,1.5603E+11,5092.111161,30708000,-393000,-0.012797968,51.63841808,30754000,-46000,0,46000
KRW-BTC,2022-08-05,2022-08-05T09:00:00,30318000,30990000,30261000,30767000,1.65974E+12,1.69448E+11,5525.870434,30315000,452000,0.014910111,49.23053247,30708000,-393000,0,393000
KRW-BTC,2022-08-06,2022-08-06T09:00:00,30767000,30843000,30509000,30534000,1.65983E+12,81425112952,2650.633559,30767000,-233000,-0.007573049,55.19274376,30315000,452000,452000,0
KRW-BTC,2022-08-07,2022-08-07T09:00:00,30534000,30899000,30440000,30685000,1.65992E+12,77019180216,2514.515032,30534000,151000,0.004945307,56.25577812,30767000,-233000,0,233000
KRW-BTC,2022-08-08,2022-08-08T09:00:00,30695000,31925000,30680000,31459000,1.66E+12,1.79949E+11,5716.184413,30685000,774000,0.025224051,56.62337662,30534000,151000,151000,0
KRW-BTC,2022-08-09,2022-08-09T09:00:00,31435000,31743000,30570000,30997000,1.66009E+12,1.74858E+11,5607.512683,31459000,-462000,-0.014685782,73.97622193,30685000,774000,774000,0
KRW-BTC,2022-08-10,2022-08-10T09:00:00,30997000,32073000,30522000,31583000,1.66018E+12,2.76307E+11,8806.557975,30997000,586000,0.018905055,70.39597737,31459000,-462000,0,462000
KRW-BTC,2022-08-11,2022-08-11T09:00:00,31583000,32879000,31581000,31770000,1.66026E+12,2.98864E+11,9244.456851,31583000,187000,0.005920907,63.41037095,30997000,586000,586000,0
KRW-BTC,2022-08-12,2022-08-12T09:00:00,31770000,32450000,31590000,32368000,1.66035E+12,2.67506E+11,8387.043922,31770000,598000,0.018822789,56.39898172,31583000,187000,187000,0
KRW-BTC,2022-08-13,2022-08-13T09:00:00,32368000,32957000,32260000,32562000,1.66044E+12,1.43161E+11,4388.330322,32368000,194000,0.005993574,60.18596788,31770000,598000,598000,0
KRW-BTC,2022-08-14,2022-08-14T09:00:00,32562000,33197000,32310000,32544000,1.66052E+12,2.08972E+11,6387.198266,32562000,-18000,-0.000552792,63.33541537,32368000,194000,194000,0
KRW-BTC,2022-08-15,2022-08-15T09:00:00,32544000,33450000,32139000,32445000,1.66061E+12,2.26009E+11,6914.807593,32544000,-99000,-0.003042035,70.89256584,32562000,-18000,0,18000
KRW-BTC,2022-08-16,2022-08-16T09:00:00,32435000,32600000,31865000,32082000,1.66069E+12,1.34649E+11,4179.746422,32445000,-363000,-0.011188165,68.57808858,32544000,-99000,0,99000
KRW-BTC,2022-08-17,2022-08-17T09:00:00,32082000,32600000,31334000,31547000,1.66078E+12,1.85426E+11,5812.249277,32082000,-535000,-0.016676018,64.57418788,32445000,-363000,0,363000
KRW-BTC,2022-08-18,2022-08-18T09:00:00,31547000,31779000,31484000,31720000,1.66087E+12,93394051416,2950.437734,31547000,173000,0.005483881,58.31516353,32082000,-535000,0,535000
KRW-BTC,2022-08-19,2022-08-19T09:00:00,31720000,31739000,28612000,28678000,1.66095E+12,3.54714E+11,11796.61947,31720000,-3042000,-0.095901639,64.55958549,31547000,173000,173000,0
KRW-BTC,2022-08-20,2022-08-20T09:00:00,28678000,29429000,28616000,29340000,1.66104E+12,1.54372E+11,5295.311618,28678000,662000,0.023083897,35.91368847,31720000,-3042000,0,3042000
KRW-BTC,2022-08-21,2022-08-21T09:00:00,29350000,29760000,29016000,29459000,1.66113E+12,1.11314E+11,3786.406886,29340000,119000,0.004055896,42.3890872,28678000,662000,662000,0
KRW-BTC,2022-08-22,2022-08-22T09:00:00,29458000,29554000,28857000,29260000,1.66121E+12,1.25495E+11,4297.803752,29459000,-199000,-0.006755151,42.1530978,29340000,119000,119000,0
KRW-BTC,2022-08-23,2022-08-23T09:00:00,29261000,29528000,28701000,29307000,1.6613E+12,1.09821E+11,3763.613823,29260000,47000,0.001606288,34.80724057,29459000,-199000,0,199000
KRW-BTC,2022-08-24,2022-08-24T09:00:00,29287000,29695000,28950000,29104000,1.66139E+12,91431871249,3125.560121,29307000,-203000,-0.006926673,37.61360305,29260000,47000,47000,0
KRW-BTC,2022-08-25,2022-08-25T09:00:00,29103000,29500000,29036000,29300000,1.66147E+12,1.01202E+11,3452.121992,29104000,196000,0.00673447,30.75011648,29307000,-203000,0,203000
KRW-BTC,2022-08-26,2022-08-26T09:00:00,29299000,29655000,27790000,27969000,1.66156E+12,2.22906E+11,7729.246705,29300000,-1331000,-0.045426621,30.84677419,29104000,196000,196000,0
KRW-BTC,2022-08-27,2022-08-27T09:00:00,27954000,28150000,27510000,27739000,1.66164E+12,86963182787,3125.256463,27969000,-230000,-0.00822339,19.3705612,29300000,-1331000,0,1331000
KRW-BTC,2022-08-28,2022-08-28T09:00:00,27739000,27878000,27090000,27099000,1.66173E+12,68413346183,2480.823587,27739000,-640000,-0.023072209,16.58583899,27969000,-230000,0,230000
KRW-BTC,2022-08-29,2022-08-29T09:00:00,27098000,28066000,27094000,27792000,1.66182E+12,1.02229E+11,3709.534914,27099000,693000,0.025572899,15.26980482,27739000,-640000,0,640000
KRW-BTC,2022-08-30,2022-08-30T09:00:00,27792000,28150000,27155000,27314000,1.6619E+12,1.17154E+11,4229.547371,27792000,-478000,-0.017199194,22.41195304,27099000,693000,693000,0
KRW-BTC,2022-08-31,2022-08-31T09:00:00,27314000,27957000,27286000,27530000,1.66199E+12,1.01806E+11,3677.299074,27314000,216000,0.007908033,22.11043519,27792000,-478000,0,478000
KRW-BTC,2022-09-01,2022-09-01T09:00:00,27521000,27773000,27100000,27636000,1.66208E+12,98555665887,3585.511308,27530000,106000,0.003850345,25.59241706,27314000,216000,216000,0
KRW-BTC,2022-09-02,2022-09-02T09:00:00,27636000,28000000,27312000,27571000,1.66216E+12,1.01532E+11,3667.657605,27636000,-65000,-0.002352005,24.98162215,27530000,106000,106000,0
KRW-BTC,2022-09-03,2022-09-03T09:00:00,27562000,27704000,27286000,27447000,1.66225E+12,51373788620,1868.628942,27571000,-124000,-0.004497479,39.32497589,27636000,-65000,0,65000
KRW-BTC,2022-09-04,2022-09-04T09:00:00,27440000,27590000,27200000,27528000,1.66234E+12,49935020084,1823.704029,27447000,81000,0.002951142,29.63202066,27571000,-124000,0,124000
KRW-BTC,2022-09-05,2022-09-05T09:00:00,27529000,27599000,27223000,27309000,1.66242E+12,96597927686,3528.468201,27528000,-219000,-0.007955536,29.05185507,27447000,81000,81000,0
KRW-BTC,2022-09-06,2022-09-06T09:00:00,27309000,27690000,26203000,26361000,1.66251E+12,2.20653E+11,8145.676585,27309000,-948000,-0.034713831,28.92633398,27528000,-219000,0,219000
KRW-BTC,2022-09-07,2022-09-07T09:00:00,26361000,27064000,26198000,26810000,1.6626E+12,1.52753E+11,5757.559321,26361000,449000,0.017032738,23.36347197,27309000,-948000,0,948000
KRW-BTC,2022-09-08,2022-09-08T09:00:00,26811000,27042000,26601000,26887000,1.66268E+12,1.143E+11,4259.432445,26810000,77000,0.002872063,30.14196676,26361000,449000,449000,0
KRW-BTC,2022-09-09,2022-09-09T09:00:00,26887000,29616000,26864000,29350000,1.66277E+12,2.79964E+11,9802.804138,26887000,2463000,0.091605609,28.67244122,26810000,77000,77000,0
KRW-BTC,2022-09-10,2022-09-10T09:00:00,29344000,29900000,29001000,29727000,1.66285E+12,1.68836E+11,5736.675057,29350000,377000,0.012844974,60.17086463,26887000,2463000,2463000,0
KRW-BTC,2022-09-11,2022-09-11T09:00:00,29727000,30030000,29527000,30028000,1.66294E+12,1.09636E+11,3688.600488,29727000,301000,0.010125475,64.33102653,29350000,377000,377000,0
KRW-BTC,2022-09-12,2022-09-12T09:00:00,30028000,30851000,29780000,30656000,1.66303E+12,2.32344E+11,7642.566033,30028000,628000,0.020913814,72.19948461,29727000,301000,301000,0
KRW-BTC,2022-09-13,2022-09-13T09:00:00,30684000,31300000,28200000,28371000,1.66311E+12,4.5181E+11,15229.11581,30656000,-2285000,-0.074536795,71.9228414,30028000,628000,628000,0
KRW-BTC,2022-09-14,2022-09-14T09:00:00,28371000,28813000,27688000,28344000,1.6632E+12,2.47271E+11,8716.782685,28371000,-27000,-0.000951676,56.33769037,30656000,-2285000,0,2285000
KRW-BTC,2022-09-15,2022-09-15T09:00:00,28352000,28518000,27774000,28024000,1.66329E+12,1.95628E+11,6939.777037,28344000,-320000,-0.011289867,54.99386503,28371000,-27000,0,27000
KRW-BTC,2022-09-16,2022-09-16T09:00:00,28029000,28173000,27453000,27915000,1.66337E+12,1.49167E+11,5350.837012,28024000,-109000,-0.003889523,52.31946437,28344000,-320000,0,320000
KRW-BTC,2022-09-17,2022-09-17T09:00:00,27916000,28357000,27893000,28174000,1.66346E+12,90962723367,3240.100437,27915000,259000,0.009278166,52.04567079,28024000,-109000,0,109000
KRW-BTC,2022-09-18,2022-09-18T09:00:00,28174000,28206000,27280000,27490000,1.66355E+12,1.11684E+11,4018.150313,28174000,-684000,-0.024277703,54.25494557,27915000,259000,259000,0
KRW-BTC,2022-09-19,2022-09-19T09:00:00,27490000,27732000,26216000,27566000,1.66363E+12,2.61036E+11,9719.59411,27490000,76000,0.002764642,49.79225891,28174000,-684000,0,684000
KRW-BTC,2022-09-20,2022-09-20T09:00:00,27566000,27707000,26582000,26757000,1.66372E+12,1.4238E+11,5253.122238,27566000,-809000,-0.029347747,51.42730201,27490000,76000,76000,0
KRW-BTC,2022-09-21,2022-09-21T09:00:00,26757000,27974000,26199000,26538000,1.6638E+12,2.49413E+11,9250.118767,26757000,-219000,-0.008184774,52.23375451,27566000,-809000,0,809000
KRW-BTC,2022-09-22,2022-09-22T09:00:00,26523000,27698000,26478000,27572000,1.66389E+12,1.61447E+11,5953.989094,26538000,1034000,0.038962997,48.42483206,26757000,-219000,0,219000
KRW-BTC,2022-09-23,2022-09-23T09:00:00,27571000,27788000,26709000,27594000,1.66398E+12,1.9758E+11,7237.642087,27572000,22000,0.000797911,53.5710562,26538000,1034000,1034000,0
KRW-BTC,2022-09-24,2022-09-24T09:00:00,27591000,27611000,27101000,27270000,1.66406E+12,79497771144,2902.696438,27594000,-324000,-0.011741683,37.72027972,27572000,22000,22000,0
KRW-BTC,2022-09-25,2022-09-25T09:00:00,27270000,27499000,26910000,27051000,1.66415E+12,67830234775,2488.1113,27270000,-219000,-0.008030803,32.68986896,27594000,-324000,0,324000
KRW-BTC,2022-09-26,2022-09-26T09:00:00,27051000,27749000,27000000,27597000,1.66424E+12,1.2705E+11,4639.446161,27051000,546000,0.020184097,28.78118318,27270000,-219000,0,219000
KRW-BTC,2022-09-27,2022-09-27T09:00:00,27604000,29112000,27130000,27501000,1.66432E+12,3.19137E+11,11326.09518,27597000,-96000,-0.003478639,27.93884321,27051000,546000,546000,0
KRW-BTC,2022-09-28,2022-09-28T09:00:00,27495000,28421000,26800000,27952000,1.66441E+12,2.14191E+11,7772.212439,27501000,451000,0.016399404,40.83052277,27597000,-96000,0,96000
KRW-BTC,2022-09-29,2022-09-29T09:00:00,27952000,28246000,27290000,28033000,1.6645E+12,1.80041E+11,6460.931579,27952000,81000,0.002897825,46.20743034,27501000,451000,451000,0
KRW-BTC,2022-09-30,2022-09-30T09:00:00,28020000,28841000,27580000,27924000,1.66458E+12,1.93003E+11,6867.902456,28033000,-109000,-0.003888275,50.09129641,27952000,81000,81000,0
KRW-BTC,2022-10-01,2022-10-01T09:00:00,27924000,28008000,27696000,27868000,1.66467E+12,70954974473,2546.825117,27924000,-56000,-0.002005443,50.09129641,28033000,-109000,0,109000
KRW-BTC,2022-10-02,2022-10-02T09:00:00,27868000,27960000,27512000,27691000,1.66476E+12,85545876530,3079.769561,27868000,-177000,-0.006351371,46.76258993,27924000,-56000,0,56000
KRW-BTC,2022-10-03,2022-10-03T09:00:00,27672000,28375000,27591000,28299000,1.66484E+12,1.10671E+11,3956.10964,27691000,608000,0.021956592,52.38208106,27868000,-177000,0,177000
KRW-BTC,2022-10-04,2022-10-04T09:00:00,28280000,29094000,28145000,28980000,1.66493E+12,1.58535E+11,5533.817065,28299000,681000,0.024064455,57.71416544,27691000,608000,608000,0
KRW-BTC,2022-10-05,2022-10-05T09:00:00,28952000,29017000,28322000,28721000,1.66501E+12,1.47817E+11,5152.71568,28980000,-259000,-0.008937198,74.04282933,28299000,681000,681000,0
KRW-BTC,2022-10-06,2022-10-06T09:00:00,28720000,28930000,28290000,28418000,1.6651E+12,1.3735E+11,4801.187682,28721000,-303000,-0.010549772,73.40767746,28980000,-259000,0,259000
KRW-BTC,2022-10-07,2022-10-07T09:00:00,28418000,28517000,27663000,27805000,1.66519E+12,1.52012E+11,5416.378592,28418000,-613000,-0.021570835,60.75788403,28721000,-303000,0,303000
KRW-BTC,2022-10-08,2022-10-08T09:00:00,27810000,27933000,27602000,27743000,1.66527E+12,58568308273,2106.945314,27805000,-62000,-0.002229815,52.33252266,28418000,-613000,0,613000
KRW-BTC,2022-10-09,2022-10-09T09:00:00,27743000,27885000,27622000,27679000,1.66536E+12,45515986562,1640.581783,27743000,-64000,-0.002306888,55.5503403,27805000,-62000,0,62000
KRW-BTC,2022-10-10,2022-10-10T09:00:00,27679000,27833000,27359000,27401000,1.66545E+12,1.15901E+11,4196.415337,27679000,-278000,-0.010043716,57.64734535,27743000,-64000,0,64000
KRW-BTC,2022-10-11,2022-10-11T09:00:00,27397000,27678000,27131000,27339000,1.66553E+12,1.0222E+11,3732.940003,27401000,-62000,-0.002262691,47.44658676,27679000,-278000,0,278000
KRW-BTC,2022-10-12,2022-10-12T09:00:00,27339000,27523000,27255000,27460000,1.66562E+12,57574795546,2101.426615,27339000,121000,0.004425912,47.87066246,27401000,-62000,0,62000
KRW-BTC,2022-10-13,2022-10-13T09:00:00,27460000,28063000,26400000,27810000,1.66571E+12,2.22278E+11,8203.958395,27460000,350000,0.012745812,42.91882556,27339000,121000,121000,0
KRW-BTC,2022-10-14,2022-10-14T09:00:00,27808000,28539000,27500000,27660000,1.66579E+12,1.48191E+11,5280.081239,27810000,-150000,-0.005393743,47.02110606,27460000,350000,350000,0
KRW-BTC,2022-10-15,2022-10-15T09:00:00,27656000,27722000,27410000,27524000,1.66588E+12,51459862485,1863.651981,27660000,-136000,-0.004916847,46.51162791,27810000,-150000,0,150000
KRW-BTC,2022-10-16,2022-10-16T09:00:00,27548000,27900000,27502000,27655000,1.66596E+12,44583425422,1613.231531,27524000,131000,0.004759483,45.54865424,27660000,-136000,0,136000
KRW-BTC,2022-10-17,2022-10-17T09:00:00,27655000,28200000,27526000,27993000,1.66605E+12,92642089153,3325.591796,27655000,338000,0.012222021,49.52854898,27524000,131000,131000,0
KRW-BTC,2022-10-18,2022-10-18T09:00:00,27995000,28180000,27530000,27812000,1.66614E+12,1.01834E+11,3645.546868,27993000,-181000,-0.006465902,45.68771139,27655000,338000,338000,0
KRW-BTC,2022-10-19,2022-10-19T09:00:00,27824000,27825000,27536000,27657000,1.66622E+12,87417949568,3160.616029,27812000,-155000,-0.005573134,30.83989501,27993000,-181000,0,181000
KRW-BTC,2022-10-20,2022-10-20T09:00:00,27639000,27800000,27400000,27505000,1.66631E+12,73944127660,2683.247993,27657000,-152000,-0.005495896,31.92934783,27812000,-155000,0,155000
KRW-BTC,2022-10-21,2022-10-21T09:00:00,27505000,27700000,27130000,27580000,1.6664E+12,76016880614,2767.62248,27505000,75000,0.002726777,33.65556749,27657000,-152000,0,152000
KRW-BTC,2022-10-22,2022-10-22T09:00:00,27600000,27700000,27547000,27620000,1.66648E+12,56235951760,2036.10495,27580000,40000,0.001450326,45.01108647,27505000,75000,75000,0
KRW-BTC,2022-10-23,2022-10-23T09:00:00,27620000,28152000,27484000,27981000,1.66657E+12,75515642883,2722.169758,27620000,361000,0.013070239,47.24585759,27580000,40000,40000,0
KRW-BTC,2022-10-24,2022-10-24T09:00:00,27981000,28077000,27663000,27803000,1.66666E+12,87079836346,3125.348991,27981000,-178000,-0.00636146,55.96837945,27620000,361000,361000,0
KRW-BTC,2022-10-25,2022-10-25T09:00:00,27803000,28844000,27621000,28494000,1.66674E+12,1.37804E+11,4893.203129,27803000,691000,0.024853433,58.27160494,27981000,-178000,0,178000
KRW-BTC,2022-10-26,2022-10-26T09:00:00,28494000,29447000,28470000,29079000,1.66683E+12,1.73489E+11,5979.876121,28494000,585000,0.020530638,68.87871854,27803000,691000,691000,0
KRW-BTC,2022-10-27,2022-10-27T09:00:00,29116000,29238000,28530000,28590000,1.66692E+12,1.49864E+11,5172.494233,29079000,-489000,-0.016816259,72.97757593,28494000,585000,585000,0
KRW-BTC,2022-10-28,2022-10-28T09:00:00,28590000,29183000,28350000,28958000,1.667E+12,98435976523,3424.861865,28590000,368000,0.012871633,60.64991808,29079000,-489000,0,489000
KRW-BTC,2022-10-29,2022-10-29T09:00:00,28932000,29497000,28910000,29091000,1.66709E+12,1.81411E+11,6211.37654,28958000,133000,0.004592859,66.72680412,28590000,368000,368000,0
KRW-BTC,2022-10-30,2022-10-30T09:00:00,29091000,29350000,28902000,28957000,1.66717E+12,91332005444,3137.068759,29091000,-134000,-0.004606236,70.20892443,28958000,133000,133000,0
KRW-BTC,2022-10-31,2022-10-31T09:00:00,28957000,29217000,28580000,28778000,1.66726E+12,1.09126E+11,3780.017757,28957000,-179000,-0.00618158,66.77835052,29091000,-134000,0,134000
KRW-BTC,2022-11-01,2022-11-01T09:00:00,28778000,28928000,28634000,28749000,1.66735E+12,84430214876,2933.716643,28778000,-29000,-0.001007714,60.54823972,28957000,-179000,0,179000
KRW-BTC,2022-11-02,2022-11-02T09:00:00,28753000,29299000,28500000,28632000,1.66743E+12,2.17669E+11,7547.861369,28749000,-117000,-0.004069707,63.12692631,28778000,-29000,0,29000
KRW-BTC,2022-11-03,2022-11-03T09:00:00,28632000,28900000,28443000,28693000,1.66752E+12,1.94087E+11,6757.692914,28632000,61000,0.002130483,63.80628717,28749000,-117000,0,117000
KRW-BTC,2022-11-04,2022-11-04T09:00:00,28685000,29679000,28683000,29388000,1.66761E+12,2.31718E+11,7964.117852,28693000,695000,0.024221936,67.26744186,28632000,61000,61000,0
KRW-BTC,2022-11-05,2022-11-05T09:00:00,29388000,29870000,29304000,29756000,1.66769E+12,1.64967E+11,5550.079702,29388000,368000,0.012522118,72.26600985,28693000,695000,695000,0
KRW-BTC,2022-11-06,2022-11-06T09:00:00,29756000,29869000,29400000,29473000,1.66778E+12,93055406232,3135.465388,29756000,-283000,-0.009510687,74.33910665,29388000,368000,368000,0
KRW-BTC,2022-11-07,2022-11-07T09:00:00,29470000,29658000,28790000,28945000,1.66787E+12,1.52159E+11,5212.344719,29473000,-528000,-0.017914702,67.30858469,29756000,-283000,0,283000
KRW-BTC,2022-11-08,2022-11-08T09:00:00,28945000,29020000,25842000,26650000,1.66795E+12,5.94772E+11,21680.49236,28945000,-2295000,-0.079288305,62.25321888,29473000,-528000,0,528000
KRW-BTC,2022-11-09,2022-11-09T09:00:00,26652000,26832000,22564000,22919000,1.66804E+12,5.52716E+11,22296.85265,26650000,-3731000,-0.14,35.28097063,28945000,-2295000,0,2295000
KRW-BTC,2022-11-10,2022-11-10T09:00:00,22924000,25120000,22840000,24779000,1.66812E+12,4.98017E+11,20710.25278,22919000,1860000,0.081155373,17.26886291,26650000,-3731000,0,3731000
KRW-BTC,2022-11-11,2022-11-11T09:00:00,24779000,24928000,23000000,23656000,1.66821E+12,3.03749E+11,12736.12608,24779000,-1123000,-0.045320634,32.32538726,22919000,1860000,1860000,0
KRW-BTC,2022-11-12,2022-11-12T09:00:00,23657000,23755000,23061000,23380000,1.6683E+12,1.11007E+11,4753.992373,23656000,-276000,-0.01166723,27.01976422,24779000,-1123000,0,1123000
KRW-BTC,2022-11-13,2022-11-13T09:00:00,23380000,23515000,22500000,22510000,1.66838E+12,1.64599E+11,7169.951279,23380000,-870000,-0.037211292,25.55013272,23656000,-276000,0,276000
KRW-BTC,2022-11-14,2022-11-14T09:00:00,22511000,23438000,21509000,22701000,1.66847E+12,3.01879E+11,13460.02193,22510000,191000,0.008485118,24.035441,23380000,-870000,0,870000
KRW-BTC,2022-11-15,2022-11-15T09:00:00,22706000,23220000,22530000,23003000,1.66856E+12,1.39067E+11,6064.33493,22701000,302000,0.013303379,25.54920737,22510000,191000,191000,0
KRW-BTC,2022-11-16,2022-11-16T09:00:00,23003000,23162000,22550000,22954000,1.66864E+12,1.10304E+11,4821.319032,23003000,-49000,-0.002130157,27.37795276,22701000,302000,302000,0
KRW-BTC,2022-11-17,2022-11-17T09:00:00,22954000,23039000,22613000,22982000,1.66873E+12,72904673242,3192.693764,22954000,28000,0.001219831,27.52533249,23003000,-49000,0,49000
KRW-BTC,2022-11-18,2022-11-18T09:00:00,22982000,23330000,22900000,23061000,1.66882E+12,81843191221,3545.619584,22982000,79000,0.003437473,27.33550282,22954000,28000,28000,0
KRW-BTC,2022-11-19,2022-11-19T09:00:00,23062000,23197000,22928000,23081000,1.6689E+12,51938225975,2254.610825,23061000,20000,0.000867265,23.60010014,22982000,79000,79000,0
KRW-BTC,2022-11-20,2022-11-20T09:00:00,23082000,23128000,22651000,22788000,1.66899E+12,92051907652,4008.068312,23081000,-293000,-0.012694424,21.31499785,23061000,20000,20000,0
KRW-BTC,2022-11-21,2022-11-21T09:00:00,22763000,22810000,22000000,22220000,1.66908E+12,1.21611E+11,5410.354567,22788000,-568000,-0.024925399,21.29669386,23081000,-293000,0,293000
KRW-BTC,2022-11-22,2022-11-22T09:00:00,22220000,22719000,22031000,22584000,1.66916E+12,1.07901E+11,4830.106826,22220000,364000,0.016381638,21.22379119,22788000,-568000,0,568000
KRW-BTC,2022-11-23,2022-11-23T09:00:00,22599000,23121000,22525000,22985000,1.66925E+12,1.03606E+11,4524.893513,22584000,401000,0.017755933,29.15726881,22220000,364000,364000,0
KRW-BTC,2022-11-24,2022-11-24T09:00:00,22985000,23220000,22566000,22738000,1.66933E+12,94860806308,4151.700544,22985000,-247000,-0.010746139,50.51369863,22584000,401000,401000,0
KRW-BTC,2022-11-25,2022-11-25T09:00:00,22735000,22794000,22370000,22676000,1.66942E+12,67806317145,3000.13345,22738000,-62000,-0.002726713,28.78819372,22985000,-247000,0,247000
KRW-BTC,2022-11-26,2022-11-26T09:00:00,22677000,22862000,22605000,22660000,1.66951E+12,48865893598,2148.775806,22676000,-16000,-0.000705592,36.93333333,22738000,-62000,0,62000
KRW-BTC,2022-11-27,2022-11-27T09:00:00,22646000,22774000,22605000,22646000,1.66959E+12,45175559593,1989.051138,22660000,-14000,-0.000617829,39.68481375,22676000,-16000,0,16000
KRW-BTC,2022-11-28,2022-11-28T09:00:00,22661000,22690000,22217000,22339000,1.66968E+12,80214477852,3579.090571,22646000,-307000,-0.013556478,52.58162491,22660000,-14000,0,14000
KRW-BTC,2022-11-29,2022-11-29T09:00:00,22329000,22617000,22155000,22417000,1.66977E+12,56647764932,2523.90821,22339000,78000,0.003491651,43.41818182,22646000,-307000,0,307000
KRW-BTC,2022-11-30,2022-11-30T09:00:00,22417000,23293000,22415000,23192000,1.66985E+12,1.07572E+11,4690.575205,22417000,775000,0.034571977,38.40063341,22339000,78000,78000,0
KRW-BTC,2022-12-01,2022-12-01T09:00:00,23209000,23400000,22871000,23002000,1.66994E+12,75761071316,3278.515197,23192000,-190000,-0.00819248,53.65928659,22417000,775000,775000,0
KRW-BTC,2022-12-02,2022-12-02T09:00:00,23008000,23046000,22650000,22877000,1.67003E+12,61755977181,2707.54917,23002000,-125000,-0.00543431,50.29291154,23192000,-190000,0,190000
KRW-BTC,2022-12-03,2022-12-03T09:00:00,22877000,22973000,22752000,22830000,1.67011E+12,31071194371,1361.730873,22877000,-47000,-0.002054465,47.34104046,23002000,-125000,0,125000
KRW-BTC,2022-12-04,2022-12-04T09:00:00,22821000,23021000,22755000,22906000,1.6702E+12,38661404072,1690.073993,22830000,76000,0.003328953,46.40091769,22877000,-47000,0,47000
KRW-BTC,2022-12-05,2022-12-05T09:00:00,22918000,23150000,22685000,22725000,1.67028E+12,83776335468,3649.930863,22906000,-181000,-0.00790186,51.80428135,22830000,76000,76000,0
KRW-BTC,2022-12-06,2022-12-06T09:00:00,22729000,22885000,22701000,22821000,1.67037E+12,64445480751,2826.97261,22725000,96000,0.004224422,58.75823795,22906000,-181000,0,181000
KRW-BTC,2022-12-07,2022-12-07T09:00:00,22837000,22898000,22400000,22544000,1.67046E+12,76371819696,3381.147876,22821000,-277000,-0.012137943,54.53154876,22725000,96000,96000,0
KRW-BTC,2022-12-08,2022-12-08T09:00:00,22544000,23000000,22484000,22918000,1.67054E+12,60238648327,2658.301222,22544000,374000,0.01658978,41.14813328,22821000,-277000,0,277000
KRW-BTC,2022-12-09,2022-12-09T09:00:00,22918000,23000000,22770000,22849000,1.67063E+12,53715032552,2349.726274,22918000,-69000,-0.003010734,53.43773873,22544000,374000,374000,0
KRW-BTC,2022-12-10,2022-12-10T09:00:00,22845000,22940000,22820000,22831000,1.67072E+12,30646589950,1339.765766,22849000,-18000,-0.000787781,53.2952381,22918000,-69000,0,69000
KRW-BTC,2022-12-11,2022-12-11T09:00:00,22824000,22915000,22760000,22775000,1.6708E+12,36350568859,1591.849025,22831000,-56000,-0.002452805,53.25466311,22849000,-18000,0,18000
KRW-BTC,2022-12-12,2022-12-12T09:00:00,22784000,22882000,22487000,22824000,1.67089E+12,55084524507,2436.297641,22775000,49000,0.002151482,52.41663544,22831000,-56000,0,56000
KRW-BTC,2022-12-13,2022-12-13T09:00:00,22824000,23600000,22570000,23161000,1.67098E+12,1.20676E+11,5226.527815,22824000,337000,0.01476516,60.05806719,22775000,49000,49000,0
KRW-BTC,2022-12-14,2022-12-14T09:00:00,23182000,23941000,23147000,23235000,1.67106E+12,94660482356,4041.52273,23161000,74000,0.003195026,63.93258427,22824000,337000,337000,0
KRW-BTC,2022-12-15,2022-12-15T09:00:00,23255000,23382000,22877000,22942000,1.67115E+12,66575698319,2875.733021,23235000,-293000,-0.012610286,51.09192483,23161000,74000,74000,0
KRW-BTC,2022-12-16,2022-12-16T09:00:00,22952000,23050000,22125000,22249000,1.67124E+12,1.05209E+11,4660.970703,22942000,-693000,-0.030206608,48.55212355,23235000,-293000,0,293000
KRW-BTC,2022-12-17,2022-12-17T09:00:00,22249000,22367000,22000000,22230000,1.67132E+12,64427612393,2908.952812,22249000,-19000,-0.000853971,38.10606061,22942000,-693000,0,693000
KRW-BTC,2022-12-18,2022-12-18T09:00:00,22230000,22299000,22111000,22210000,1.67141E+12,41937018170,1889.620794,22230000,-20000,-0.000899685,38.51454824,22249000,-19000,0,19000
KRW-BTC,2022-12-19,2022-12-19T09:00:00,22214000,22240000,21521000,21654000,1.67149E+12,69541093991,3169.233834,22210000,-556000,-0.025033769,36.38497653,22230000,-20000,0,20000
KRW-BTC,2022-12-20,2022-12-20T09:00:00,21654000,22221000,21585000,22011000,1.67158E+12,67692054188,3084.657137,21654000,357000,0.016486561,31.72978506,22210000,-556000,0,556000
KRW-BTC,2022-12-21,2022-12-21T09:00:00,22017000,22065000,21874000,21943000,1.67167E+12,44278935562,2014.947645,22011000,-68000,-0.003089364,37.31203008,21654000,357000,357000,0
KRW-BTC,2022-12-22,2022-12-22T09:00:00,21943000,21980000,21659000,21891000,1.67175E+12,54875642302,2511.79403,21943000,-52000,-0.002369776,39.92624874,22011000,-68000,0,68000
KRW-BTC,2022-12-23,2022-12-23T09:00:00,21891000,22000000,21764000,21872000,1.67184E+12,49294615581,2253.906288,21891000,-19000,-0.000867937,30.70274333,21943000,-52000,0,52000
KRW-BTC,2022-12-24,2022-12-24T09:00:00,21884000,21985000,21858000,21951000,1.67193E+12,26154354236,1191.820305,21872000,79000,0.003611924,31.29069322,21891000,-19000,0,19000
KRW-BTC,2022-12-25,2022-12-25T09:00:00,21951000,21962000,21776000,21848000,1.67201E+12,44679760075,2041.54109,21951000,-103000,-0.004692269,33.53293413,21872000,79000,79000,0
KRW-BTC,2022-12-26,2022-12-26T09:00:00,21854000,21861000,21596000,21702000,1.6721E+12,55317974480,2548.577853,21848000,-146000,-0.006682534,32.95329165,21951000,-103000,0,103000
KRW-BTC,2022-12-27,2022-12-27T09:00:00,21711000,21745000,21242000,21321000,1.67219E+12,61104995861,2842.52451,21702000,-381000,-0.017555986,30.078125,21848000,-146000,0,146000
KRW-BTC,2022-12-28,2022-12-28T09:00:00,21324000,21396000,21010000,21061000,1.67227E+12,66752520284,3151.280761,21321000,-260000,-0.01219455,17.83216783,21702000,-381000,0,381000
KRW-BTC,2022-12-29,2022-12-29T09:00:00,21061000,21295000,20908000,21201000,1.67236E+12,51975879185,2464.457822,21061000,140000,0.006647358,14.31385424,21321000,-260000,0,260000
KRW-BTC,2022-12-30,2022-12-30T09:00:00,21201000,21232000,20700000,21070000,1.67244E+12,56577073270,2699.072216,21201000,-131000,-0.006178954,19.91012789,21061000,140000,140000,0
KRW-BTC,2022-12-31,2022-12-31T09:00:00,21086000,21249000,20966000,21079000,1.67253E+12,62530539957,2960.900095,21070000,9000,0.000427148,24.71042471,21201000,-131000,0,131000
KRW-BTC,2023-01-01,2023-01-01T09:00:00,21079000,21171000,21002000,21123000,1.67262E+12,31357935910,1486.467553,21079000,44000,0.002087386,25.20465317,21070000,9000,9000,0
KRW-BTC,2023-01-02,2023-01-02T09:00:00,21128000,21400000,21047000,21215000,1.6727E+12,54848830816,2578.844531,21123000,92000,0.004355442,26.82302772,21079000,44000,44000,0
KRW-BTC,2023-01-03,2023-01-03T09:00:00,21209000,21451000,21178000,21351000,1.67279E+12,44770082697,2097.615306,21215000,136000,0.006410559,38.33067517,21123000,92000,92000,0
KRW-BTC,2023-01-04,2023-01-04T09:00:00,21351000,21732000,21341000,21588000,1.67288E+12,53380293696,2479.248182,21351000,237000,0.011100183,30.12048193,21215000,136000,136000,0
KRW-BTC,2023-01-05,2023-01-05T09:00:00,21589000,21641000,21404000,21575000,1.67296E+12,76705645075,3563.010235,21588000,-13000,-0.000602186,40.2952433,21351000,237000,237000,0
KRW-BTC,2023-01-06,2023-01-06T09:00:00,21575000,21593000,21280000,21517000,1.67305E+12,70377645236,3285.376716,21575000,-58000,-0.002688297,41.17318436,21588000,-13000,0,13000
KRW-BTC,2023-01-07,2023-01-07T09:00:00,21517000,21585000,21467000,21539000,1.67314E+12,27012968306,1254.833337,21517000,22000,0.001022447,40.2952433,21575000,-58000,0,58000
KRW-BTC,2023-01-08,2023-01-08T09:00:00,21539000,21760000,21498000,21704000,1.67322E+12,33262049871,1541.669355,21539000,165000,0.007660523,38.37471783,21517000,22000,22000,0
KRW-BTC,2023-01-09,2023-01-09T09:00:00,21704000,21844000,21628000,21655000,1.67331E+12,75081619993,3454.033478,21704000,-49000,-0.002257648,46.07415485,21539000,165000,165000,0
KRW-BTC,2023-01-10,2023-01-10T09:00:00,21655000,21960000,21558000,21916000,1.6734E+12,57169463343,2628.434564,21655000,261000,0.012052644,48.64709269,21704000,-49000,0,49000
KRW-BTC,2023-01-11,2023-01-11T09:00:00,21916000,22501000,21871000,22485000,1.67348E+12,67549706545,3066.635492,21916000,569000,0.025962767,68.3982684,21655000,261000,261000,0
KRW-BTC,2023-01-12,2023-01-12T09:00:00,22475000,23900000,22415000,23552000,1.67357E+12,1.75963E+11,7650.901631,22485000,1067000,0.047453858,86.96780893,21916000,569000,569000,0
KRW-BTC,2023-01-13,2023-01-13T09:00:00,23546000,24902000,23378000,24802000,1.67365E+12,1.54691E+11,6444.405014,23552000,1250000,0.053074049,91.20224325,22485000,1067000,1067000,0
KRW-BTC,2023-01-14,2023-01-14T09:00:00,24802000,26201000,24766000,25881000,1.67374E+12,3.68031E+11,14303.124,24802000,1079000,0.043504556,96.97885196,23552000,1250000,1250000,0
KRW-BTC,2023-01-15,2023-01-15T09:00:00,25873000,25990000,25447000,25836000,1.67383E+12,1.22545E+11,4769.18418,25881000,-45000,-0.001738727,97.61999207,24802000,1079000,1079000,0
KRW-BTC,2023-01-16,2023-01-16T09:00:00,25857000,26585000,25600000,26368000,1.67391E+12,1.42898E+11,5477.232713,25836000,532000,0.020591423,96.72813801,25881000,-45000,0,45000
KRW-BTC,2023-01-17,2023-01-17T09:00:00,26327000,26662000,25989000,26255000,1.674E+12,1.04329E+11,3964.854832,26368000,-113000,-0.004285498,96.99069852,25836000,532000,532000,0
KRW-BTC,2023-01-18,2023-01-18T09:00:00,26255000,26795000,25502000,25718000,1.67409E+12,2.1671E+11,8246.642922,26255000,-537000,-0.020453247,94.90842491,26368000,-113000,0,113000
KRW-BTC,2023-01-19,2023-01-19T09:00:00,25701000,26299000,25690000,26205000,1.67417E+12,84733146462,3265.225511,25718000,487000,0.018936154,85.85069444,26255000,-537000,0,537000
KRW-BTC,2023-01-20,2023-01-20T09:00:00,26208000,28105000,26101000,28026000,1.67426E+12,1.61784E+11,6019.113075,26205000,1821000,0.069490555,87.13506577,25718000,487000,487000,0
KRW-BTC,2023-01-21,2023-01-21T09:00:00,28025000,29000000,27721000,28333000,1.67435E+12,2.03651E+11,7165.779761,28026000,307000,0.010954114,90.69651119,26205000,1821000,1821000,0
KRW-BTC,2023-01-22,2023-01-22T09:00:00,28333000,28706000,27937000,28390000,1.67443E+12,1.23705E+11,4350.789211,28333000,57000,0.002011788,91.01666264,28026000,307000,307000,0
KRW-BTC,2023-01-23,2023-01-23T09:00:00,28400000,28890000,28220000,28609000,1.67452E+12,1.27364E+11,4463.876856,28390000,219000,0.007713984,90.89796917,28333000,57000,57000,0
KRW-BTC,2023-01-24,2023-01-24T09:00:00,28600000,28951000,28014000,28351000,1.6746E+12,1.73224E+11,6049.392006,28609000,-258000,-0.009018141,91.67066155,28390000,219000,219000,0
KRW-BTC,2023-01-25,2023-01-25T09:00:00,28363000,29524000,28001000,28736000,1.67469E+12,1.9132E+11,6714.843842,28351000,385000,0.013579768,88.57451145,28609000,-258000,0,258000
KRW-BTC,2023-01-26,2023-01-26T09:00:00,28736000,29081000,28692000,28930000,1.67478E+12,1.30733E+11,4523.706467,28736000,194000,0.006751114,88.31678313,28351000,385000,385000,0
KRW-BTC,2023-01-27,2023-01-27T09:00:00,28930000,29336000,28456000,28950000,1.67486E+12,1.17148E+11,4064.651432,28930000,20000,0.000691324,86.91652938,28736000,194000,194000,0
KRW-BTC,2023-01-28,2023-01-28T09:00:00,28950000,29118000,28800000,29063000,1.67495E+12,83196227169,2868.918095,28950000,113000,0.003903282,84.25834159,28930000,20000,20000,0
KRW-BTC,2023-01-29,2023-01-29T09:00:00,29064000,29922000,28984000,29670000,1.67504E+12,1.44402E+11,4907.892474,29063000,607000,0.020885662,81.26965409,28950000,113000,113000,0
KRW-BTC,2023-01-30,2023-01-30T09:00:00,29657000,29777000,28323000,28706000,1.67512E+12,2.02515E+11,6952.229202,29670000,-964000,-0.032490731,83.92920354,29063000,607000,607000,0
KRW-BTC,2023-01-31,2023-01-31T09:00:00,28724000,29225000,28430000,29064000,1.67521E+12,1.32599E+11,4605.268544,28706000,358000,0.01247126,69.2206511,29670000,-964000,0,964000
KRW-BTC,2023-02-01,2023-02-01T09:00:00,29052000,29740000,28626000,29620000,1.6753E+12,1.64242E+11,5637.916748,29064000,556000,0.019130195,72.1985143,28706000,358000,358000,0
KRW-BTC,2023-02-02,2023-02-02T09:00:00,29599000,30285000,29530000,29600000,1.67538E+12,1.87941E+11,6298.033361,29620000,-20000,-0.000675219,80.74377561,29064000,556000,556000,0
KRW-BTC,2023-02-03,2023-02-03T09:00:00,29601000,29734000,29287000,29432000,1.67547E+12,1.39973E+11,4743.686426,29600000,-168000,-0.005675676,78.87395816,29620000,-20000,0,20000
KRW-BTC,2023-02-04,2023-02-04T09:00:00,29432000,29650000,29349000,29420000,1.67556E+12,86210318405,2924.16283,29432000,-12000,-0.00040772,66.63511595,29600000,-168000,0,168000
KRW-BTC,2023-02-05,2023-02-05T09:00:00,29398000,29528000,28827000,28990000,1.67564E+12,1.23824E+11,4235.890746,29420000,-430000,-0.014615908,63.82599847,29432000,-12000,0,12000
KRW-BTC,2023-02-06,2023-02-06T09:00:00,28990000,29439000,28650000,29222000,1.67573E+12,3.54107E+11,12169.80778,28990000,232000,0.00800276,56.97026022,29420000,-430000,0,430000
KRW-BTC,2023-02-07,2023-02-07T09:00:00,29225000,29561000,29017000,29452000,1.67581E+12,4.75484E+11,16246.13827,29222000,230000,0.007870782,57.09983785,28990000,232000,232000,0
KRW-BTC,2023-02-08,2023-02-08T09:00:00,29452000,29591000,28940000,29303000,1.6759E+12,2.88002E+11,9798.406279,29452000,-149000,-0.005059079,62.83515971,29222000,230000,230000,0
KRW-BTC,2023-02-09,2023-02-09T09:00:00,29303000,29400000,28135000,28193000,1.67599E+12,3.62647E+11,12573.15275,29303000,-1110000,-0.037880081,56.99481865,29452000,-149000,0,149000
KRW-BTC,2023-02-10,2023-02-10T09:00:00,28193000,28350000,27916000,28120000,1.67607E+12,1.63803E+11,5826.760545,28193000,-73000,-0.002589295,42.58402093,29303000,-1110000,0,1110000
KRW-BTC,2023-02-11,2023-02-11T09:00:00,28145000,28379000,28057000,28377000,1.67616E+12,1.30207E+11,4616.926761,28120000,257000,0.009139403,41.73636002,28193000,-73000,0,73000
KRW-BTC,2023-02-12,2023-02-12T09:00:00,28360000,28490000,28141000,28263000,1.67625E+12,1.11502E+11,3940.503342,28377000,-114000,-0.004017338,43.3604336,28120000,257000,257000,0
KRW-BTC,2023-02-13,2023-02-13T09:00:00,28264000,28379000,27910000,28309000,1.67633E+12,1.53339E+11,5446.98589,28263000,46000,0.00162757,34.9454312,28377000,-114000,0,114000
KRW-BTC,2023-02-14,2023-02-14T09:00:00,28334000,28850000,27950000,28798000,1.67642E+12,2.29703E+11,8113.171475,28309000,489000,0.017273659,44.71371505,28263000,46000,46000,0
KRW-BTC,2023-02-15,2023-02-15T09:00:00,28782000,31400000,28611000,31186000,1.67651E+12,3.81238E+11,12911.88083,28798000,2388000,0.082922425,46.57745754,28309000,489000,489000,0
KRW-BTC,2023-02-16,2023-02-16T09:00:00,31183000,32458000,30400000,30451000,1.67659E+12,4.03863E+11,12781.37026,31186000,-735000,-0.023568268,63.69359916,28798000,2388000,2388000,0
KRW-BTC,2023-02-17,2023-02-17T09:00:00,30466000,32090000,30278000,31641000,1.67668E+12,2.84422E+11,9141.337837,30451000,1190000,0.039079176,56.61433235,31186000,-735000,0,735000
KRW-BTC,2023-02-18,2023-02-18T09:00:00,31641000,32014000,31498000,31789000,1.67676E+12,1.67371E+11,5267.640332,31641000,148000,0.004677475,64.81556003,30451000,1190000,1190000,0
KRW-BTC,2023-02-19,2023-02-19T09:00:00,31789000,32370000,31400000,31435000,1.67685E+12,2.60367E+11,8172.916254,31789000,-354000,-0.011135928,65.60400474,31641000,148000,148000,0
KRW-BTC,2023-02-20,2023-02-20T09:00:00,31434000,32148000,31000000,31883000,1.67694E+12,2.55796E+11,8070.986785,31435000,448000,0.01425163,66.26746507,31789000,-354000,0,354000
KRW-BTC,2023-02-21,2023-02-21T09:00:00,31883000,32600000,31510000,31736000,1.67702E+12,3.01631E+11,9416.928529,31883000,-147000,-0.004610608,67.20993403,31435000,448000,448000,0
KRW-BTC,2023-02-22,2023-02-22T09:00:00,31751000,31850000,30900000,31619000,1.67711E+12,2.42632E+11,7731.257667,31736000,-117000,-0.003686665,64.93200837,31883000,-147000,0,147000
KRW-BTC,2023-02-23,2023-02-23T09:00:00,31638000,31999000,30960000,31398000,1.6772E+12,2.15198E+11,6836.964022,31619000,-221000,-0.006989468,65.20483193,31736000,-117000,0,117000
KRW-BTC,2023-02-24,2023-02-24T09:00:00,31400000,31485000,30560000,30877000,1.67728E+12,2.10551E+11,6775.08623,31398000,-521000,-0.016593414,73.8219117,31619000,-221000,0,221000
KRW-BTC,2023-02-25,2023-02-25T09:00:00,30868000,31000000,30291000,30959000,1.67737E+12,1.44553E+11,4719.684896,30877000,82000,0.002655698,69.21254355,31398000,-521000,0,521000
KRW-BTC,2023-02-26,2023-02-26T09:00:00,30959000,31384000,30710000,31279000,1.67746E+12,94938741700,3065.820302,30959000,320000,0.010336251,68.44285714,30877000,82000,82000,0
KRW-BTC,2023-02-27,2023-02-27T09:00:00,31279000,31654000,30890000,31255000,1.67754E+12,1.47494E+11,4718.974256,31279000,-24000,-0.000767288,70.92700527,30959000,320000,320000,0
KRW-BTC,2023-02-28,2023-02-28T09:00:00,31255000,31323000,30904000,31024000,1.67763E+12,1.11817E+11,3593.407573,31255000,-231000,-0.007390818,70.50389755,31279000,-24000,0,24000
KRW-BTC,2023-03-01,2023-03-01T09:00:00,31024000,31600000,30805000,31106000,1.67772E+12,1.4161E+11,4532.684876,31024000,82000,0.002643115,66.06988161,31255000,-231000,0,231000
KRW-BTC,2023-03-02,2023-03-02T09:00:00,31106000,31284000,30800000,31109000,1.6778E+12,1.42039E+11,4579.437716,31106000,3000,9.64E-05,49.13419913,31024000,82000,82000,0
KRW-BTC,2023-03-03,2023-03-03T09:00:00,31109000,31135000,29508000,29709000,1.67789E+12,2.18344E+11,7298.817853,31109000,-1400000,-0.045003054,58.46193416,31106000,3000,3000,0
KRW-BTC,2023-03-04,2023-03-04T09:00:00,29710000,29907000,29638000,29838000,1.67797E+12,66213470511,2222.291205,29709000,129000,0.004342119,26.42752562,31109000,-1400000,0,1400000
KRW-BTC,2023-03-05,2023-03-05T09:00:00,29837000,30097000,29650000,29982000,1.67806E+12,65484864545,2189.45391,29838000,144000,0.004826061,26.08482471,29709000,129000,129000,0
KRW-BTC,2023-03-06,2023-03-06T09:00:00,29982000,30066000,29638000,29769000,1.67815E+12,71803338820,2405.786232,29982000,-213000,-0.007104263,31.22253812,29838000,144000,144000,0
KRW-BTC,2023-03-07,2023-03-07T09:00:00,29769000,29978000,29250000,29579000,1.67823E+12,2.27062E+11,7624.354355,29769000,-190000,-0.006382478,20.91359384,29982000,-213000,0,213000
KRW-BTC,2023-03-08,2023-03-08T09:00:00,29579000,29660000,29000000,29023000,1.67832E+12,1.61635E+11,5501.293981,29579000,-556000,-0.01879712,20.66902366,29769000,-190000,0,190000
KRW-BTC,2023-03-09,2023-03-09T09:00:00,29018000,29320000,27415000,27604000,1.67841E+12,2.8076E+11,9841.876226,29023000,-1419000,-0.048892258,18.46452867,29579000,-556000,0,556000
KRW-BTC,2023-03-10,2023-03-10T09:00:00,27604000,27605000,26707000,27343000,1.67849E+12,2.63313E+11,9730.63224,27604000,-261000,-0.009455151,14.30184419,29023000,-1419000,0,1419000
KRW-BTC,2023-03-11,2023-03-11T09:00:00,27341000,28023000,26870000,27737000,1.67858E+12,1.71121E+11,6228.739374,27343000,394000,0.014409538,15.03759398,27604000,-261000,0,261000
KRW-BTC,2023-03-12,2023-03-12T09:00:00,27722000,29300000,27167000,29199000,1.67867E+12,1.71679E+11,6122.085574,27737000,1462000,0.052709377,19.97763697,27343000,394000,394000,0
KRW-BTC,2023-03-13,2023-03-13T09:00:00,29190000,32000000,28855000,31676000,1.67875E+12,4.23405E+11,13888.83821,29199000,2477000,0.084831672,34.0196681,27737000,1462000,1462000,0
KRW-BTC,2023-03-14,2023-03-14T09:00:00,31676000,34469000,31579000,32490000,1.67884E+12,5.87878E+11,17872.07888,31676000,814000,0.025697689,52.34906818,29199000,2477000,2477000,0
KRW-BTC,2023-03-15,2023-03-15T09:00:00,32491000,33500000,32000000,32511000,1.67892E+12,3.62916E+11,11093.60435,32490000,21000,0.000646353,57.68021794,31676000,814000,814000,0
KRW-BTC,2023-03-16,2023-03-16T09:00:00,32505000,33455000,32307000,33335000,1.67901E+12,2.2427E+11,6814.433495,32511000,824000,0.025345268,57.40799325,32490000,21000,21000,0
KRW-BTC,2023-03-17,2023-03-17T09:00:00,33309000,36649000,33300000,36207000,1.6791E+12,5.27069E+11,15037.60037,33335000,2872000,0.086155692,60.80163043,32511000,824000,824000,0
KRW-BTC,2023-03-18,2023-03-18T09:00:00,36207000,36649000,35500000,35767000,1.67918E+12,3.3652E+11,9300.231741,36207000,-440000,-0.012152346,77.59001359,33335000,2872000,2872000,0
KRW-BTC,2023-03-19,2023-03-19T09:00:00,35760000,37526000,35657000,37233000,1.67927E+12,2.91635E+11,7991.516267,35767000,1466000,0.040987502,74.52635062,36207000,-440000,0,440000
KRW-BTC,2023-03-20,2023-03-20T09:00:00,37228000,37838000,36217000,37295000,1.67936E+12,3.80937E+11,10244.52549,37233000,62000,0.00166519,77.03781043,35767000,1466000,1466000,0
KRW-BTC,2023-03-21,2023-03-21T09:00:00,37294000,37634000,36500000,37221000,1.67944E+12,3.2451E+11,8735.63835,37295000,-74000,-0.00198418,78.38286318,37233000,62000,62000,0
KRW-BTC,2023-03-22,2023-03-22T09:00:00,37202000,38400000,35584000,36372000,1.67953E+12,4.01966E+11,10824.62086,37221000,-849000,-0.022809704,79.07472226,37295000,-74000,0,74000
KRW-BTC,2023-03-23,2023-03-23T09:00:00,36372000,37660000,35930000,37274000,1.67962E+12,2.67746E+11,7303.530589,36372000,902000,0.024799296,77.35020469,37221000,-849000,0,849000
KRW-BTC,2023-03-24,2023-03-24T09:00:00,37268000,37599000,36304000,36749000,1.6797E+12,2.32253E+11,6250.396203,37274000,-525000,-0.014084885,87.42839449,36372000,902000,902000,0
KRW-BTC,2023-03-25,2023-03-25T09:00:00,36750000,36969000,36510000,36750000,1.67979E+12,1.09275E+11,2977.380398,36749000,1000,2.72E-05,85.67743893,37274000,-525000,0,525000
KRW-BTC,2023-03-26,2023-03-26T09:00:00,36750000,37432000,36632000,37160000,1.67988E+12,1.14388E+11,3091.039577,36750000,410000,0.011156463,85.23731332,36749000,1000,1000,0
KRW-BTC,2023-03-27,2023-03-27T09:00:00,37156000,37282000,35444000,36110000,1.67996E+12,2.49875E+11,6840.889777,37160000,-1050000,-0.02825619,83.91411775,36750000,410000,410000,0
KRW-BTC,2023-03-28,2023-03-28T09:00:00,36124000,36220000,35230000,36026000,1.68005E+12,1.84981E+11,5170.686229,36110000,-84000,-0.002326225,71.50339476,37160000,-1050000,0,1050000
KRW-BTC,2023-03-29,2023-03-29T09:00:00,36020000,37750000,36006000,37401000,1.68013E+12,2.39193E+11,6442.797567,36026000,1375000,0.03816688,68.45511482,36110000,-84000,0,84000
KRW-BTC,2023-03-30,2023-03-30T09:00:00,37402000,38424000,36800000,37157000,1.68022E+12,2.66205E+11,7063.165325,37401000,-244000,-0.00652389,72.36144138,36026000,1375000,1375000,0
KRW-BTC,2023-03-31,2023-03-31T09:00:00,37157000,37771000,36596000,37540000,1.68031E+12,2.18147E+11,5856.700495,37157000,383000,0.010307614,68.45663512,37401000,-244000,0,244000
KRW-BTC,2023-04-01,2023-04-01T09:00:00,37540000,37950000,37449000,37585000,1.68039E+12,1.10077E+11,2923.339953,37540000,45000,0.001198721,58.47425302,37157000,383000,383000,0
KRW-BTC,2023-04-02,2023-04-02T09:00:00,37596000,37700000,37000000,37301000,1.68048E+12,1.43258E+11,3827.714808,37585000,-284000,-0.007556206,62.1686747,37540000,45000,45000,0
KRW-BTC,2023-04-03,2023-04-03T09:00:00,37296000,37768000,36378000,36814000,1.68057E+12,1.98293E+11,5344.455628,37301000,-487000,-0.01305595,50.54071247,37585000,-284000,0,284000
KRW-BTC,2023-04-04,2023-04-04T09:00:00,36814000,37552000,36660000,37205000,1.68065E+12,1.27944E+11,3443.096644,36814000,391000,0.010620959,46.41739908,37301000,-487000,0,487000
KRW-BTC,2023-04-05,2023-04-05T09:00:00,37207000,37804000,36948000,37139000,1.68074E+12,1.79847E+11,4804.317546,37205000,-66000,-0.001773955,49.88620199,36814000,391000,391000,0
KRW-BTC,2023-04-06,2023-04-06T09:00:00,37139000,37211000,36800000,37058000,1.68083E+12,1.20836E+11,3265.195674,37139000,-81000,-0.002180996,56.13894669,37205000,-66000,0,66000
KRW-BTC,2023-04-07,2023-04-07T09:00:00,37058000,37200000,36890000,36993000,1.68091E+12,81178209965,2191.385527,37058000,-65000,-0.001754007,48.00958349,37139000,-81000,0,81000
KRW-BTC,2023-04-08,2023-04-08T09:00:00,36993000,37249000,36930000,37080000,1.681E+12,1.1301E+11,3044.987229,36993000,87000,0.002351796,52.4567056,37058000,-65000,0,65000
KRW-BTC,2023-04-09,2023-04-09T09:00:00,37064000,37576000,36878000,37313000,1.68108E+12,1.42854E+11,3846.312156,37080000,233000,0.006283711,53.26603325,36993000,87000,87000,0
KRW-BTC,2023-04-10,2023-04-10T09:00:00,37331000,39183000,37255000,38985000,1.68117E+12,2.56656E+11,6752.314109,37313000,1672000,0.04481012,51.56923077,37080000,233000,233000,0
KRW-BTC,2023-04-11,2023-04-11T09:00:00,38981000,40260000,38903000,40004000,1.68126E+12,3.21713E+11,8105.884583,38985000,1019000,0.026138258,76.15062762,37313000,1672000,1672000,0
KRW-BTC,2023-04-12,2023-04-12T09:00:00,40005000,40610000,39567000,39699000,1.68134E+12,4.26144E+11,10654.28564,40004000,-305000,-0.007624238,80.92350746,38985000,1019000,1019000,0
KRW-BTC,2023-04-13,2023-04-13T09:00:00,39694000,40198000,39689000,39911000,1.68143E+12,2.06205E+11,5171.072562,39699000,212000,0.005340185,71.42857143,40004000,-305000,0,305000
KRW-BTC,2023-04-14,2023-04-14T09:00:00,39912000,40333000,39470000,39804000,1.68152E+12,2.22612E+11,5561.144021,39911000,-107000,-0.002680965,75.83489681,39699000,212000,212000,0
KRW-BTC,2023-04-15,2023-04-15T09:00:00,39804000,39999000,39752000,39800000,1.6816E+12,77290046948,1938.560581,39804000,-4000,-0.000100492,72.39810051,39911000,-107000,0,107000
KRW-BTC,2023-04-16,2023-04-16T09:00:00,39800000,39981000,39600000,39607000,1.68169E+12,95129039158,2393.495282,39800000,-193000,-0.004849246,72.09255935,39804000,-4000,0,4000
KRW-BTC,2023-04-17,2023-04-17T09:00:00,39612000,39673000,38506000,38700000,1.68178E+12,2.11323E+11,5420.857259,39607000,-907000,-0.022899992,73.42543681,39800000,-193000,0,193000
KRW-BTC,2023-04-18,2023-04-18T09:00:00,38700000,39847000,38251000,39630000,1.68186E+12,1.95161E+11,4976.831513,38700000,930000,0.024031008,67.65256458,39607000,-907000,0,907000
KRW-BTC,2023-04-19,2023-04-19T09:00:00,39637000,39719000,38181000,38300000,1.68195E+12,2.3829E+11,6118.482472,39630000,-1330000,-0.033560434,70.61724197,38700000,930000,930000,0
KRW-BTC,2023-04-20,2023-04-20T09:00:00,38300000,38572000,37400000,37672000,1.68204E+12,2.09814E+11,5515.281884,38300000,-628000,-0.016396867,58.12456263,39630000,-1330000,0,1330000
KRW-BTC,2023-04-21,2023-04-21T09:00:00,37672000,37779000,36108000,36337000,1.68212E+12,2.19819E+11,5934.619511,37672000,-1335000,-0.03543746,53.99115965,38300000,-628000,0,628000
KRW-BTC,2023-04-22,2023-04-22T09:00:00,36337000,37318000,36055000,37182000,1.68221E+12,1.35958E+11,3716.224626,36337000,845000,0.023254534,46.34010266,37672000,-1335000,0,1335000
KRW-BTC,2023-04-23,2023-04-23T09:00:00,37182000,37198000,36524000,36802000,1.68229E+12,71532980981,1942.104681,37182000,-380000,-0.010219999,50.52469136,36337000,845000,845000,0
KRW-BTC,2023-04-24,2023-04-24T09:00:00,36802000,37297000,36200000,36750000,1.68238E+12,1.34682E+11,3663.660318,36802000,-52000,-0.001412967,47.41056045,37182000,-380000,0,380000
KRW-BTC,2023-04-25,2023-04-25T09:00:00,36750000,38123000,36359000,37877000,1.68247E+12,1.61727E+11,4364.40529,36750000,1127000,0.030666667,36.44961804,36802000,-52000,0,52000
KRW-BTC,2023-04-26,2023-04-26T09:00:00,37877000,39850000,36749000,38017000,1.68255E+12,3.79352E+11,9856.33567,37877000,140000,0.003696175,37.27109515,36750000,1127000,1127000,0
KRW-BTC,2023-04-27,2023-04-27T09:00:00,38020000,39730000,37959000,39258000,1.68264E+12,2.54468E+11,6531.806592,38017000,1241000,0.032643291,39.73137973,37877000,140000,140000,0
KRW-BTC,2023-04-28,2023-04-28T09:00:00,39271000,39500000,38711000,39083000,1.68273E+12,1.31889E+11,3370.009267,39258000,-175000,-0.00445769,46.45840113,38017000,1241000,1241000,0
KRW-BTC,2023-04-29,2023-04-29T09:00:00,39083000,39247000,38800000,38965000,1.68281E+12,68531904105,1753.92556,39083000,-118000,-0.003019216,46.11822978,39258000,-175000,0,175000
KRW-BTC,2023-04-30,2023-04-30T09:00:00,38980000,39830000,38809000,39149000,1.6829E+12,1.31847E+11,3356.944859,38965000,184000,0.004722187,45.55898309,39083000,-118000,0,118000
KRW-BTC,2023-05-01,2023-05-01T09:00:00,39149000,39303000,37372000,37769000,1.68299E+12,2.08928E+11,5466.444454,39149000,-1380000,-0.035249943,47.56175468,38965000,184000,184000,0
KRW-BTC,2023-05-02,2023-05-02T09:00:00,37768000,38680000,37428000,38405000,1.68307E+12,1.81116E+11,4771.65437,37769000,636000,0.016839207,45.28129752,39149000,-1380000,0,1380000
KRW-BTC,2023-05-03,2023-05-03T09:00:00,38406000,39050000,37800000,38703000,1.68316E+12,2.00814E+11,5239.850975,38405000,298000,0.007759406,43.60045972,37769000,636000,636000,0
KRW-BTC,2023-05-04,2023-05-04T09:00:00,38733000,39112000,38423000,38580000,1.68324E+12,1.56123E+11,4027.302864,38703000,-123000,-0.003178048,52.3597611,38405000,298000,298000,0
KRW-BTC,2023-05-05,2023-05-05T09:00:00,38599000,39359000,38520000,39053000,1.68333E+12,2.18659E+11,5614.210355,38580000,473000,0.012260239,55.65098332,38703000,-123000,0,123000
KRW-BTC,2023-05-06,2023-05-06T09:00:00,39077000,39435000,38142000,38677000,1.68342E+12,1.73684E+11,4471.184936,39053000,-376000,-0.009627942,68.93474624,38580000,473000,473000,0
KRW-BTC,2023-05-07,2023-05-07T09:00:00,38679000,38953000,38143000,38143000,1.6835E+12,93899192064,2434.4776,38677000,-534000,-0.013806655,61.15172311,39053000,-376000,0,376000
KRW-BTC,2023-05-08,2023-05-08T09:00:00,38152000,38369000,36822000,37255000,1.68359E+12,2.07034E+11,5517.375187,38143000,-888000,-0.023280812,59.77832872,38677000,-534000,0,534000
KRW-BTC,2023-05-09,2023-05-09T09:00:00,37260000,37544000,36822000,37150000,1.68368E+12,1.366E+11,3678.21436,37255000,-105000,-0.002818414,53.2822046,38143000,-888000,0,888000
KRW-BTC,2023-05-10,2023-05-10T09:00:00,37150000,37995000,36580000,37071000,1.68376E+12,1.68854E+11,4525.28288,37150000,-79000,-0.002126514,44.55104182,37255000,-105000,0,105000
KRW-BTC,2023-05-11,2023-05-11T09:00:00,37072000,37232000,36260000,36411000,1.68385E+12,1.31341E+11,3570.391377,37071000,-660000,-0.017803674,42.84417549,37150000,-79000,0,79000
KRW-BTC,2023-05-12,2023-05-12T09:00:00,36413000,36554000,35262000,36341000,1.68394E+12,1.96578E+11,5478.839683,36411000,-70000,-0.001922496,26.38911926,37071000,-660000,0,660000
KRW-BTC,2023-05-13,2023-05-13T09:00:00,36341000,36662000,36143000,36374000,1.68402E+12,67979133829,1868.095465,36341000,33000,0.000908065,26.85685348,36411000,-70000,0,70000
KRW-BTC,2023-05-14,2023-05-14T09:00:00,36382000,36800000,36193000,36415000,1.68411E+12,59726505226,1639.208331,36374000,41000,0.001127179,27.81298167,36341000,33000,33000,0
KRW-BTC,2023-05-15,2023-05-15T09:00:00,36420000,37200000,36204000,36632000,1.6842E+12,98300162815,2671.265833,36415000,217000,0.005959083,26.00070225,36374000,41000,41000,0
KRW-BTC,2023-05-16,2023-05-16T09:00:00,36642000,36795000,36335000,36421000,1.68428E+12,76375961495,2091.338965,36632000,-211000,-0.005759991,37.45863666,36415000,217000,217000,0
KRW-BTC,2023-05-17,2023-05-17T09:00:00,36419000,36835000,35938000,36700000,1.68437E+12,1.16588E+11,3207.189783,36421000,279000,0.007660416,25.85199611,36632000,-211000,0,211000
KRW-BTC,2023-05-18,2023-05-18T09:00:00,36706000,36920000,35800000,36240000,1.68445E+12,1.23989E+11,3396.670938,36700000,-460000,-0.01253406,25.50745904,36421000,279000,279000,0
KRW-BTC,2023-05-19,2023-05-19T09:00:00,36240000,36486000,35950000,36156000,1.68454E+12,93622400558,2587.514507,36240000,-84000,-0.002317881,23.56529598,36700000,-460000,0,460000
KRW-BTC,2023-05-20,2023-05-20T09:00:00,36156000,36475000,36119000,36385000,1.68463E+12,42561799025,1174.320819,36156000,229000,0.006333665,14.11939559,36240000,-84000,0,84000
KRW-BTC,2023-05-21,2023-05-21T09:00:00,36404000,36618000,36048000,36051000,1.68471E+12,57153092942,1573.059469,36385000,-334000,-0.009179607,20.53984576,36156000,229000,229000,0
KRW-BTC,2023-05-22,2023-05-22T09:00:00,36057000,36200000,35709000,35947000,1.6848E+12,93326194209,2597.921922,36051000,-104000,-0.002884802,21.65311653,36385000,-334000,0,334000
KRW-BTC,2023-05-23,2023-05-23T09:00:00,35947000,36660000,35841000,36381000,1.68489E+12,91284785438,2510.275788,35947000,434000,0.01207333,27.49483827,36051000,-104000,0,104000
KRW-BTC,2023-05-24,2023-05-24T09:00:00,36382000,36430000,35144000,35452000,1.68497E+12,1.59941E+11,4471.519601,36381000,-929000,-0.025535307,38.11437403,35947000,434000,434000,0
KRW-BTC,2023-05-25,2023-05-25T09:00:00,35465000,35670000,35000000,35547000,1.68506E+12,1.19701E+11,3394.737419,35452000,95000,0.00267968,30.18359853,36381000,-929000,0,929000
KRW-BTC,2023-05-26,2023-05-26T09:00:00,35550000,36110000,35284000,35771000,1.68515E+12,84409771662,2369.161622,35547000,224000,0.006301516,37.72727273,35452000,95000,95000,0
KRW-BTC,2023-05-27,2023-05-27T09:00:00,35786000,35900000,35588000,35824000,1.68523E+12,68717026294,1922.454836,35771000,53000,0.001481647,42.24278715,35547000,224000,224000,0
KRW-BTC,2023-05-28,2023-05-28T09:00:00,35824000,37532000,35788000,37350000,1.68532E+12,1.40995E+11,3852.977529,35824000,1526000,0.042597142,42.5554954,35771000,53000,53000,0
KRW-BTC,2023-05-29,2023-05-29T09:00:00,37360000,37883000,36802000,36992000,1.6854E+12,1.50323E+11,4032.112929,37350000,-358000,-0.009585007,59.02683916,35824000,1526000,1526000,0
KRW-BTC,2023-05-30,2023-05-30T09:00:00,36992000,37402000,36821000,36914000,1.68549E+12,1.21697E+11,3280.205365,36992000,-78000,-0.002108564,53.38345865,37350000,-358000,0,358000
KRW-BTC,2023-05-31,2023-05-31T09:00:00,36923000,37043000,36059000,36391000,1.68558E+12,1.39599E+11,3833.617703,36914000,-523000,-0.014168066,54.75226528,36992000,-78000,0,78000
KRW-BTC,2023-06-01,2023-06-01T09:00:00,36391000,36509000,35715000,35823000,1.68566E+12,1.22585E+11,3403.840081,36391000,-568000,-0.015608255,47.15522003,36914000,-523000,0,523000
KRW-BTC,2023-06-02,2023-06-02T09:00:00,35823000,36150000,35470000,36089000,1.68575E+12,1.12363E+11,3129.382447,35823000,266000,0.007425397,46.23578263,36391000,-568000,0,568000
KRW-BTC,2023-06-03,2023-06-03T09:00:00,36089000,36102000,35801000,35888000,1.68584E+12,69221217633,1925.565561,36089000,-201000,-0.005569564,49.41443804,35823000,266000,266000,0
KRW-BTC,2023-06-04,2023-06-04T09:00:00,35888000,36146000,35820000,35865000,1.68592E+12,60341276257,1679.790548,35888000,-23000,-0.000640883,45.63499034,36089000,-201000,0,201000
KRW-BTC,2023-06-05,2023-06-05T09:00:00,35894000,35896000,33825000,34298000,1.68601E+12,2.37454E+11,6815.063125,35865000,-1567000,-0.043691621,48.27201784,35888000,-23000,0,23000
KRW-BTC,2023-06-06,2023-06-06T09:00:00,34299000,35993000,33580000,35852000,1.6861E+12,1.86634E+11,5402.995691,34298000,1554000,0.045308764,37.95471147,35865000,-1567000,0,1567000
KRW-BTC,2023-06-07,2023-06-07T09:00:00,35855000,35993000,34797000,34952000,1.68618E+12,1.59665E+11,4520.05491,35852000,-900000,-0.025103202,46.67922159,34298000,1554000,1554000,0
KRW-BTC,2023-06-08,2023-06-08T09:00:00,34953000,35416000,34802000,34996000,1.68627E+12,83003582915,2370.319951,34952000,44000,0.001258869,46.84979839,35852000,-900000,0,900000
KRW-BTC,2023-06-09,2023-06-09T09:00:00,34996000,35161000,34802000,34865000,1.68636E+12,81645858995,2335.692703,34996000,-131000,-0.003743285,46.5060241,34952000,44000,44000,0
KRW-BTC,2023-06-10,2023-06-10T09:00:00,34865000,34914000,33842000,34372000,1.68644E+12,2.06801E+11,6040.928715,34865000,-493000,-0.014140255,44.18634497,34996000,-131000,0,131000
KRW-BTC,2023-06-11,2023-06-11T09:00:00,34370000,34639000,34016000,34345000,1.68653E+12,60157124443,1754.273109,34372000,-27000,-0.000785523,41.18075802,34865000,-493000,0,493000
KRW-BTC,2023-06-12,2023-06-12T09:00:00,34345000,34480000,33950000,34059000,1.68661E+12,80694211076,2362.404561,34345000,-286000,-0.008327267,27.68453884,34372000,-27000,0,27000
KRW-BTC,2023-06-13,2023-06-13T09:00:00,34059000,34479000,33808000,33913000,1.6867E+12,1.23075E+11,3607.818513,34059000,-146000,-0.004286679,27.98378622,34345000,-286000,0,286000
KRW-BTC,2023-06-14,2023-06-14T09:00:00,33913000,34119000,32779000,33007000,1.68679E+12,1.38289E+11,4128.490874,33913000,-906000,-0.026715419,27.70099569,34059000,-146000,0,146000
KRW-BTC,2023-06-15,2023-06-15T09:00:00,33007000,33618000,32510000,33449000,1.68687E+12,1.26536E+11,3841.664425,33007000,442000,0.013391099,26.20922385,33913000,-906000,0,906000
KRW-BTC,2023-06-16,2023-06-16T09:00:00,33449000,34758000,33121000,34501000,1.68696E+12,1.15189E+11,3402.645026,33449000,1052000,0.031450866,33.00887489,33007000,442000,442000,0
KRW-BTC,2023-06-17,2023-06-17T09:00:00,34515000,35080000,34320000,34780000,1.68705E+12,90252767869,2597.636499,34501000,279000,0.008086722,39.78383942,33449000,1052000,1052000,0
KRW-BTC,2023-06-18,2023-06-18T09:00:00,34780000,34942000,34463000,34466000,1.68713E+12,54970891902,1583.139651,34780000,-314000,-0.009028177,42.94267516,34501000,279000,279000,0
KRW-BTC,2023-06-19,2023-06-19T09:00:00,34466000,35375000,34455000,35092000,1.68722E+12,87104793340,2502.201132,34466000,626000,0.018162827,41.40768947,34780000,-314000,0,314000
KRW-BTC,2023-06-20,2023-06-20T09:00:00,35095000,37100000,35000000,36946000,1.68731E+12,1.97248E+11,5488.63849,35092000,1854000,0.052832554,55.51388889,34466000,626000,626000,0
KRW-BTC,2023-06-21,2023-06-21T09:00:00,36955000,40100000,36870000,39135000,1.68739E+12,4.18735E+11,10873.3844,36946000,2189000,0.059248633,57.29333333,35092000,1854000,1854000,0
KRW-BTC,2023-06-22,2023-06-22T09:00:00,39135000,39861000,38901000,39125000,1.68748E+12,2.59991E+11,6599.230546,39135000,-10000,-0.000255526,73.79679144,36946000,2189000,2189000,0
KRW-BTC,2023-06-23,2023-06-23T09:00:00,39125000,41388000,39111000,40651000,1.68756E+12,3.22774E+11,8004.819339,39125000,1526000,0.039003195,73.58081097,39135000,-10000,0,10000
KRW-BTC,2023-06-24,2023-06-24T09:00:00,40651000,40931000,40383000,40659000,1.68765E+12,1.60035E+11,3933.825602,40651000,8000,0.000196797,78.50246305,39125000,1526000,1526000,0
KRW-BTC,2023-06-25,2023-06-25T09:00:00,40659000,41399000,40197000,40352000,1.68774E+12,1.82727E+11,4478.466286,40659000,-307000,-0.007550604,82.5245732,40651000,8000,8000,0
KRW-BTC,2023-06-26,2023-06-26T09:00:00,40352000,40599000,39555000,40077000,1.68782E+12,1.98613E+11,4959.92503,40352000,-275000,-0.006815028,80.20110608,40659000,-307000,0,307000
KRW-BTC,2023-06-27,2023-06-27T09:00:00,40094000,40950000,39963000,40585000,1.68791E+12,1.66867E+11,4130.902659,40077000,508000,0.0126756,80.28991343,40352000,-275000,0,275000
KRW-BTC,2023-06-28,2023-06-28T09:00:00,40587000,40629000,39966000,40020000,1.688E+12,1.20211E+11,2988.757824,40585000,-565000,-0.0139214,82.4009324,40077000,508000,508000,0
KRW-BTC,2023-06-29,2023-06-29T09:00:00,40017000,41048000,39997000,40583000,1.68808E+12,1.41777E+11,3490.488265,40020000,563000,0.014067966,85.22350578,40585000,-565000,0,565000
KRW-BTC,2023-06-30,2023-06-30T09:00:00,40583000,41569000,39500000,40547000,1.68817E+12,3.48869E+11,8585.543862,40583000,-36000,-0.000887071,85.40095276,40020000,563000,563000,0
KRW-BTC,2023-07-01,2023-07-01T09:00:00,40547000,40877000,40391000,40691000,1.68826E+12,1.10149E+11,2709.937088,40547000,144000,0.003551434,83.36644592,40583000,-36000,0,36000
KRW-BTC,2023-07-02,2023-07-02T09:00:00,40712000,40875000,40250000,40652000,1.68834E+12,90738583549,2235.268698,40691000,-39000,-0.000958443,83.11484594,40547000,144000,144000,0
KRW-BTC,2023-07-03,2023-07-03T09:00:00,40652000,41377000,40470000,41200000,1.68843E+12,1.33827E+11,3276.857913,40652000,548000,0.013480272,85.75722543,40691000,-39000,0,39000
KRW-BTC,2023-07-04,2023-07-04T09:00:00,41200000,41388000,40540000,40610000,1.68852E+12,1.32297E+11,3230.332134,41200000,-590000,-0.014320388,85.62762483,40652000,548000,548000,0
KRW-BTC,2023-07-05,2023-07-05T09:00:00,40610000,40775000,39801000,40385000,1.6886E+12,1.44846E+11,3595.751886,40610000,-225000,-0.005540507,75.06841817,41200000,-590000,0,590000
KRW-BTC,2023-07-06,2023-07-06T09:00:00,40385000,41500000,39838000,39860000,1.68869E+12,2.33755E+11,5759.5913,40385000,-525000,-0.012999876,61.69535928,40610000,-225000,0,225000
KRW-BTC,2023-07-07,2023-07-07T09:00:00,39864000,40330000,39676000,40240000,1.68877E+12,1.07607E+11,2687.615798,39860000,380000,0.009533367,56.27240143,40385000,-525000,0,525000
KRW-BTC,2023-07-08,2023-07-08T09:00:00,40241000,40253000,39920000,40153000,1.68886E+12,52108582786,1299.849637,40240000,-87000,-0.002162028,45.63971992,39860000,380000,380000,0
KRW-BTC,2023-07-09,2023-07-09T09:00:00,40154000,40302000,39770000,39832000,1.68895E+12,59452578236,1485.270126,40153000,-321000,-0.007994421,44.72036728,40240000,-87000,0,87000
KRW-BTC,2023-07-10,2023-07-10T09:00:00,39839000,40784000,39666000,40050000,1.68903E+12,1.13229E+11,2829.62291,39832000,218000,0.005472987,44.59009571,40153000,-321000,0,321000
KRW-BTC,2023-07-11,2023-07-11T09:00:00,40060000,40387000,39946000,40117000,1.68912E+12,1.01896E+11,2541.057294,40050000,67000,0.001672909,49.71572963,39832000,218000,218000,0
KRW-BTC,2023-07-12,2023-07-12T09:00:00,40117000,40600000,39751000,39804000,1.68921E+12,1.30055E+11,3241.640081,40117000,-313000,-0.007802179,44.56824513,40050000,67000,67000,0
KRW-BTC,2023-07-13,2023-07-13T09:00:00,39803000,40456000,39356000,40112000,1.68929E+12,3.17548E+11,7976.011394,39804000,308000,0.007737916,47.33727811,40117000,-313000,0,313000
KRW-BTC,2023-07-14,2023-07-14T09:00:00,40101000,40220000,38710000,39092000,1.68938E+12,2.28311E+11,5755.461237,40112000,-1020000,-0.025428799,43.80426204,39804000,308000,308000,0
KRW-BTC,2023-07-15,2023-07-15T09:00:00,39092000,39144000,38786000,38889000,1.68947E+12,1.12934E+11,2903.658013,39092000,-203000,-0.005192878,34.79623824,40112000,-1020000,0,1020000
KRW-BTC,2023-07-16,2023-07-16T09:00:00,38889000,39153000,38687000,38933000,1.68955E+12,78716573653,2022.773684,38889000,44000,0.001131425,31.39966969,39092000,-203000,0,203000
KRW-BTC,2023-07-17,2023-07-17T09:00:00,38946000,39022000,38350000,38742000,1.68964E+12,1.002E+11,2582.395505,38933000,-191000,-0.004905864,32.27469581,38889000,44000,44000,0
KRW-BTC,2023-07-18,2023-07-18T09:00:00,38761000,38828000,38098000,38401000,1.68972E+12,99975576153,2601.55599,38742000,-341000,-0.008801817,22.64024933,38933000,-191000,0,191000
KRW-BTC,2023-07-19,2023-07-19T09:00:00,38402000,38850000,38300000,38323000,1.68981E+12,93724792758,2432.746782,38401000,-78000,-0.002031197,23.96888994,38742000,-341000,0,341000
KRW-BTC,2023-07-20,2023-07-20T09:00:00,38322000,39100000,38316000,38567000,1.6899E+12,1.25557E+11,3246.540523,38323000,244000,0.006366934,24.82910156,38401000,-78000,0,78000
KRW-BTC,2023-07-21,2023-07-21T09:00:00,38567000,38908000,38530000,38829000,1.68998E+12,81362364430,2103.139412,38567000,262000,0.006793373,33.05373526,38323000,244000,244000,0
KRW-BTC,2023-07-22,2023-07-22T09:00:00,38838000,38934000,38600000,38776000,1.69007E+12,56067219917,1447.078391,38829000,-53000,-0.001364959,30.9169597,38567000,262000,262000,0
KRW-BTC,2023-07-23,2023-07-23T09:00:00,38759000,39220000,38625000,38945000,1.69016E+12,85916107564,2211.149273,38776000,169000,0.004358366,31.2039312,38829000,-53000,0,53000
KRW-BTC,2023-07-24,2023-07-24T09:00:00,38944000,39019000,37700000,37892000,1.69024E+12,1.68113E+11,4398.31412,38945000,-1053000,-0.027038131,37.36827115,38776000,169000,169000,0
KRW-BTC,2023-07-25,2023-07-25T09:00:00,37892000,38116000,37626000,37910000,1.69033E+12,92057859896,2433.922188,37892000,18000,0.000475034,25.17257248,38945000,-1053000,0,1053000
KRW-BTC,2023-07-26,2023-07-26T09:00:00,37910000,38300000,37700000,37918000,1.69042E+12,93970927660,2477.262893,37910000,8000,0.000211026,24.31929253,37892000,18000,18000,0
KRW-BTC,2023-07-27,2023-07-27T09:00:00,37918000,38299000,37841000,37874000,1.6905E+12,1.24634E+11,3271.726557,37918000,-44000,-0.001160399,26.37775551,37910000,8000,8000,0
KRW-BTC,2023-07-28,2023-07-28T09:00:00,37877000,38200000,37704000,37932000,1.69059E+12,1.12304E+11,2964.594742,37874000,58000,0.001531394,19.98390558,37918000,-44000,0,44000
KRW-BTC,2023-07-29,2023-07-29T09:00:00,37932000,38052000,37879000,37901000,1.69068E+12,44801815216,1180.678133,37932000,-31000,-0.000817252,29.03109183,37874000,58000,58000,0
KRW-BTC,2023-07-30,2023-07-30T09:00:00,37901000,38150000,37762000,37850000,1.69076E+12,90157027232,2378.176619,37901000,-51000,-0.001345611,30.95605243,37932000,-31000,0,31000
KRW-BTC,2023-07-31,2023-07-31T09:00:00,37850000,38139000,37805000,37929000,1.69085E+12,90563421409,2383.010126,37850000,79000,0.002087186,29.1810842,37901000,-51000,0,51000
KRW-BTC,2023-08-01,2023-08-01T09:00:00,37928000,38684000,37510000,38642000,1.69093E+12,1.14971E+11,3035.900693,37929000,713000,0.018798281,33.66813982,37850000,79000,79000,0
KRW-BTC,2023-08-02,2023-08-02T09:00:00,38642000,39131000,38142000,38358000,1.69102E+12,1.29357E+11,3344.799977,38642000,-284000,-0.007349516,54.21181405,37929000,713000,713000,0
KRW-BTC,2023-08-03,2023-08-03T09:00:00,38358000,38800000,38215000,38436000,1.69111E+12,78153136650,2032.7357,38358000,78000,0.002033474,50.57059015,38642000,-284000,0,284000
KRW-BTC,2023-08-04,2023-08-04T09:00:00,38436000,38715000,38250000,38492000,1.69119E+12,87010045474,2256.946674,38436000,56000,0.001456967,47.74215788,38358000,78000,78000,0
KRW-BTC,2023-08-05,2023-08-05T09:00:00,38493000,38590000,38341000,38474000,1.69128E+12,81362884396,2113.696775,38492000,-18000,-0.00046763,43.74768089,38436000,56000,56000,0
KRW-BTC,2023-08-06,2023-08-06T09:00:00,38476000,38788000,38432000,38605000,1.69137E+12,1.35926E+11,3520.869684,38474000,131000,0.003404897,44.32330827,38492000,-18000,0,18000
KRW-BTC,2023-08-07,2023-08-07T09:00:00,38605000,38809000,38081000,38622000,1.69145E+12,2.7316E+11,7095.416315,38605000,17000,0.000440358,43.51639969,38474000,131000,131000,0
KRW-BTC,2023-08-08,2023-08-08T09:00:00,38622000,39580000,38570000,39437000,1.69154E+12,1.54368E+11,3956.683155,38622000,815000,0.021101963,73.01387137,38605000,17000,17000,0
KRW-BTC,2023-08-09,2023-08-09T09:00:00,39437000,39850000,39076000,39209000,1.69163E+12,1.30305E+11,3299.568675,39437000,-228000,-0.005781373,82.03944608,38622000,815000,815000,0
KRW-BTC,2023-08-10,2023-08-10T09:00:00,39209000,39397000,39010000,39119000,1.69171E+12,1.06359E+11,2713.945532,39209000,-90000,-0.002295391,74.79830964,39437000,-228000,0,228000
KRW-BTC,2023-08-11,2023-08-11T09:00:00,39119000,39410000,39050000,39233000,1.6918E+12,73582617605,1877.912104,39119000,114000,0.002914185,73.49943375,39209000,-90000,0,90000
KRW-BTC,2023-08-12,2023-08-12T09:00:00,39233000,39316000,39099000,39283000,1.69188E+12,56930932272,1450.679978,39233000,50000,0.001274437,74.04805915,39119000,114000,114000,0
KRW-BTC,2023-08-13,2023-08-13T09:00:00,39283000,39330000,39101000,39118000,1.69197E+12,51963334856,1323.873086,39283000,-165000,-0.00420029,75.3671072,39233000,50000,50000,0
KRW-BTC,2023-08-14,2023-08-14T09:00:00,39118000,39640000,38895000,39288000,1.69206E+12,88257787754,2247.998748,39118000,170000,0.004345826,72.33967583,39283000,-165000,0,165000
KRW-BTC,2023-08-15,2023-08-15T09:00:00,39288000,39668000,39275000,39404000,1.69214E+12,1.33573E+11,3383.235842,39288000,116000,0.002952556,73.19904404,39118000,170000,170000,0
KRW-BTC,2023-08-16,2023-08-16T09:00:00,39404000,39600000,39001000,39001000,1.69223E+12,1.63197E+11,4144.931326,39404000,-403000,-0.010227388,66.33790738,39288000,116000,116000,0
KRW-BTC,2023-08-17,2023-08-17T09:00:00,39001000,39092000,36261000,36588000,1.69232E+12,3.47989E+11,9224.234795,39001000,-2413000,-0.061870209,63.11709506,39404000,-403000,0,403000
KRW-BTC,2023-08-18,2023-08-18T09:00:00,36588000,36848000,35384000,35890000,1.6924E+12,3.34395E+11,9256.752346,36588000,-698000,-0.019077293,30.69368993,39001000,-2413000,0,2413000
KRW-BTC,2023-08-19,2023-08-19T09:00:00,35899000,36240000,35587000,36056000,1.69249E+12,95846647159,2670.316058,35890000,166000,0.004625244,26.03168755,36588000,-698000,0,698000
KRW-BTC,2023-08-20,2023-08-20T09:00:00,36071000,36225000,35754000,35949000,1.69258E+12,59546393016,1654.936938,36056000,-107000,-0.002967606,28.31779053,35890000,166000,166000,0
KRW-BTC,2023-08-21,2023-08-21T09:00:00,35946000,35967000,35500000,35769000,1.69266E+12,76516804611,2142.999606,35949000,-180000,-0.005007093,26.08069164,36056000,-107000,0,107000
KRW-BTC,2023-08-22,2023-08-22T09:00:00,35769000,35877000,35150000,35684000,1.69275E+12,86694305846,2434.37426,35769000,-85000,-0.002376359,25.03937008,35949000,-180000,0,180000
KRW-BTC,2023-08-23,2023-08-23T09:00:00,35686000,36350000,35320000,35941000,1.69284E+12,80152294407,2242.666454,35684000,257000,0.007202107,12.35707121,35769000,-85000,0,85000
KRW-BTC,2023-08-24,2023-08-24T09:00:00,35941000,36056000,35330000,35635000,1.69292E+12,67798438137,1899.019937,35941000,-306000,-0.008513953,17.4112485,35684000,257000,257000,0
KRW-BTC,2023-08-25,2023-08-25T09:00:00,35646000,35797000,35200000,35479000,1.69301E+12,75050156287,2117.114615,35635000,-156000,-0.004377719,16.69216061,35941000,-306000,0,306000
KRW-BTC,2023-08-26,2023-08-26T09:00:00,35479000,35564000,35385000,35398000,1.69309E+12,23834379919,672.2723791,35479000,-81000,-0.002283041,14.39681335,35635000,-156000,0,156000
KRW-BTC,2023-08-27,2023-08-27T09:00:00,35400000,35553000,35374000,35402000,1.69318E+12,29946645613,845.2534645,35398000,4000,0.000113001,13.36979068,35479000,-81000,0,81000
KRW-BTC,2023-08-28,2023-08-28T09:00:00,35400000,35544000,35050000,35335000,1.69327E+12,64012919015,1815.490578,35402000,-67000,-0.001892548,13.86619992,35398000,4000,4000,0
KRW-BTC,2023-08-29,2023-08-29T09:00:00,35335000,37932000,35138000,37445000,1.69335E+12,2.5711E+11,6996.579278,35335000,2110000,0.059714164,10.77594761,35402000,-67000,0,67000
KRW-BTC,2023-08-30,2023-08-30T09:00:00,37441000,37568000,36760000,37109000,1.69344E+12,1.67177E+11,4503.918254,37445000,-336000,-0.008973161,36.07279966,35335000,2110000,2110000,0
KRW-BTC,2023-08-31,2023-08-31T09:00:00,37110000,37500000,35400000,35502000,1.69353E+12,1.86018E+11,5086.618688,37109000,-1607000,-0.043304859,36.41975309,37445000,-336000,0,336000
KRW-BTC,2023-09-01,2023-09-01T09:00:00,35502000,35695000,35000000,35350000,1.69361E+12,1.95426E+11,5520.94616,35502000,-152000,-0.004281449,41.18506494,37109000,-1607000,0,1607000
KRW-BTC,2023-09-02,2023-09-02T09:00:00,35350000,35570000,35006000,35204000,1.6937E+12,2.23347E+11,6333.543065,35350000,-146000,-0.004130127,45.19059494,35502000,-152000,0,152000
KRW-BTC,2023-09-03,2023-09-03T09:00:00,35204000,35444000,35105000,35308000,1.69379E+12,99038833088,2810.799368,35204000,104000,0.00295421,42.38469789,35350000,-146000,0,146000
KRW-BTC,2023-09-04,2023-09-04T09:00:00,35312000,35350000,34863000,35011000,1.69387E+12,1.15261E+11,3280.507677,35308000,-297000,-0.008411691,44.26757288,35204000,104000,104000,0
KRW-BTC,2023-09-05,2023-09-05T09:00:00,35035000,35207000,34791000,35056000,1.69396E+12,1.05914E+11,3025.893623,35011000,45000,0.00128531,43.36019622,35308000,-297000,0,297000
KRW-BTC,2023-09-06,2023-09-06T09:00:00,35054000,35310000,34730000,35029000,1.69404E+12,73930132719,2111.499814,35056000,-27000,-0.000770196,44.46012703,35011000,45000,45000,0
KRW-BTC,2023-09-07,2023-09-07T09:00:00,35025000,35864000,34903000,35615000,1.69413E+12,70004865290,1985.800076,35029000,586000,0.016728996,41.61456418,35056000,-27000,0,27000
KRW-BTC,2023-09-08,2023-09-08T09:00:00,35644000,35823000,35020000,35295000,1.69422E+12,92224176187,2600.367182,35615000,-320000,-0.008984978,49.82511368,35029000,586000,586000,0
KRW-BTC,2023-09-09,2023-09-09T09:00:00,35295000,35314000,35150000,35280000,1.6943E+12,43632447690,1238.278634,35295000,-15000,-0.000424989,48.43590615,35615000,-320000,0,320000
KRW-BTC,2023-09-10,2023-09-10T09:00:00,35280000,35450000,35030000,35196000,1.69439E+12,62283181152,1767.332687,35280000,-84000,-0.002380952,48.98555708,35295000,-15000,0,15000
KRW-BTC,2023-09-11,2023-09-11T09:00:00,35196000,35256000,34100000,34327000,1.69448E+12,1.35719E+11,3912.709301,35196000,-869000,-0.024690306,48.25305292,35280000,-84000,0,84000
KRW-BTC,2023-09-12,2023-09-12T09:00:00,34330000,35861000,34286000,35077000,1.69456E+12,1.64963E+11,4685.113669,34327000,750000,0.021848691,42.47536578,35196000,-869000,0,869000
KRW-BTC,2023-09-13,2023-09-13T09:00:00,35076000,35749000,35000000,35497000,1.69465E+12,1.22085E+11,3451.70003,35077000,420000,0.011973658,27.81940802,34327000,750000,750000,0
KRW-BTC,2023-09-14,2023-09-14T09:00:00,35499000,36310000,35408000,35889000,1.69474E+12,1.34019E+11,3742.612355,35497000,392000,0.011043187,35.13463667,35077000,420000,420000,0
KRW-BTC,2023-09-15,2023-09-15T09:00:00,35872000,36193000,35547000,35928000,1.69482E+12,1.19727E+11,3336.887555,35889000,39000,0.001086684,54.59947706,35497000,392000,392000,0
KRW-BTC,2023-09-16,2023-09-16T09:00:00,35907000,36051000,35800000,35938000,1.69491E+12,78755069543,2192.885125,35928000,10000,0.000278334,57.05911089,35889000,39000,39000,0
KRW-BTC,2023-09-17,2023-09-17T09:00:00,35939000,35996000,35650000,35758000,1.695E+12,72102028929,2014.744093,35938000,-180000,-0.005008626,59.27235978,35928000,10000,10000,0
KRW-BTC,2023-09-18,2023-09-18T09:00:00,35758000,36801000,35658000,36000000,1.69508E+12,1.42795E+11,3943.41751,35758000,242000,0.006767716,55.57759048,35938000,-180000,0,180000
KRW-BTC,2023-09-19,2023-09-19T09:00:00,36000000,36820000,35750000,36500000,1.69517E+12,1.12444E+11,3097.748505,36000000,500000,0.013888889,62.42774566,35758000,242000,242000,0
KRW-BTC,2023-09-20,2023-09-20T09:00:00,36509000,36743000,36150000,36501000,1.69525E+12,1.04079E+11,2853.881703,36500000,1000,2.74E-05,66.28326567,36000000,500000,500000,0
KRW-BTC,2023-09-21,2023-09-21T09:00:00,36502000,36659000,35818000,36012000,1.69534E+12,1.24717E+11,3438.838699,36501000,-489000,-0.013396893,66.6969147,36500000,1000,1000,0
KRW-BTC,2023-09-22,2023-09-22T09:00:00,35989000,36129000,35900000,35952000,1.69543E+12,74758845754,2075.654597,36012000,-60000,-0.001666111,54.60450012,36501000,-489000,0,489000
KRW-BTC,2023-09-23,2023-09-23T09:00:00,35964000,36019000,35901000,35960000,1.69551E+12,35937760416,999.5539958,35952000,8000,0.000222519,58.10910886,36012000,-60000,0,60000
KRW-BTC,2023-09-24,2023-09-24T09:00:00,35951000,36100000,35500000,35534000,1.6956E+12,58720732365,1635.89364,35960000,-426000,-0.011846496,58.40751731,35952000,8000,8000,0
KRW-BTC,2023-09-25,2023-09-25T09:00:00,35530000,35701000,35176000,35491000,1.69569E+12,1.0182E+11,2877.482697,35534000,-43000,-0.001210109,53.85316917,35960000,-426000,0,426000
KRW-BTC,2023-09-26,2023-09-26T09:00:00,35497000,35805000,35428000,35566000,1.69577E+12,78730861955,2209.875078,35491000,75000,0.002113212,66.34831461,35534000,-43000,0,43000
KRW-BTC,2023-09-27,2023-09-27T09:00:00,35566000,36485000,35560000,35982000,1.69586E+12,1.18005E+11,3281.146517,35566000,416000,0.011696564,58.47487002,35491000,75000,75000,0
KRW-BTC,2023-09-28,2023-09-28T09:00:00,35979000,36999000,35933000,36596000,1.69595E+12,1.03097E+11,2834.062676,35982000,614000,0.017064088,58.41721624,35566000,416000,416000,0
KRW-BTC,2023-09-29,2023-09-29T09:00:00,36596000,36868000,36260000,36444000,1.69603E+12,67355567372,1841.587064,36596000,-152000,-0.004153459,61.3922011,35982000,614000,614000,0
KRW-BTC,2023-09-30,2023-09-30T09:00:00,36444000,36740000,36404000,36600000,1.69612E+12,50218206635,1372.416153,36444000,156000,0.00428054,58.02238806,36596000,-152000,0,152000
KRW-BTC,2023-10-01,2023-10-01T09:00:00,36614000,37817000,36555000,37789000,1.6962E+12,1.01274E+11,2733.222524,36600000,1189000,0.032486339,59.84533016,36444000,156000,156000,0
KRW-BTC,2023-10-02,2023-10-02T09:00:00,37788000,38720000,37200000,37424000,1.69629E+12,1.86314E+11,4894.786344,37789000,-365000,-0.009658895,73.23266987,36600000,1189000,1189000,0
KRW-BTC,2023-10-03,2023-10-03T09:00:00,37424000,37791000,37012000,37197000,1.69638E+12,97326904657,2600.082357,37424000,-227000,-0.006065626,65.84334668,37789000,-365000,0,365000
KRW-BTC,2023-10-04,2023-10-04T09:00:00,37198000,37740000,37036000,37595000,1.69646E+12,89233400444,2387.111967,37197000,398000,0.010699788,58.25633736,37424000,-227000,0,227000
KRW-BTC,2023-10-05,2023-10-05T09:00:00,37592000,38096000,37240000,37258000,1.69655E+12,87537921532,2329.615625,37595000,-337000,-0.008963958,61.84495453,37197000,398000,398000,0
KRW-BTC,2023-10-06,2023-10-06T09:00:00,37258000,38124000,37050000,37798000,1.69664E+12,90184643588,2400.327927,37258000,540000,0.014493532,63.94984326,37595000,-337000,0,337000
KRW-BTC,2023-10-07,2023-10-07T09:00:00,37798000,37997000,37725000,37902000,1.69672E+12,38115140032,1006.087642,37798000,104000,0.002751468,68.66154468,37258000,540000,540000,0
KRW-BTC,2023-10-08,2023-10-08T09:00:00,37902000,38109000,37587000,37929000,1.69681E+12,71305648927,1880.642389,37902000,27000,0.000712364,69.25823086,37798000,104000,104000,0
KRW-BTC,2023-10-09,2023-10-09T09:00:00,37929000,38047000,37237000,37595000,1.6969E+12,1.19979E+11,3186.875405,37929000,-334000,-0.008805927,75.79151411,37902000,27000,27000,0
KRW-BTC,2023-10-10,2023-10-10T09:00:00,37595000,37810000,37262000,37336000,1.69698E+12,78432728980,2088.596467,37595000,-259000,-0.006889214,71.32144305,37929000,-334000,0,334000
KRW-BTC,2023-10-11,2023-10-11T09:00:00,37323000,37403000,36291000,36671000,1.69707E+12,1.21704E+11,3302.248165,37336000,-665000,-0.017811228,67.2919109,37595000,-259000,0,259000
KRW-BTC,2023-10-12,2023-10-12T09:00:00,36671000,36880000,36408000,36750000,1.69716E+12,64503382511,1763.265496,36671000,79000,0.002154291,56.41885597,37336000,-665000,0,665000
KRW-BTC,2023-10-13,2023-10-13T09:00:00,36750000,37193000,36724000,36968000,1.69724E+12,64841512795,1756.990238,36750000,218000,0.005931973,51.59354305,36671000,79000,79000,0
KRW-BTC,2023-10-14,2023-10-14T09:00:00,36968000,37156000,36700000,36790000,1.69733E+12,45151269086,1222.065339,36968000,-178000,-0.004814975,55.34912209,36750000,218000,218000,0
KRW-BTC,2023-10-15,2023-10-15T09:00:00,36790000,37189000,36659000,37086000,1.69741E+12,60732500501,1648.56771,36790000,296000,0.008045665,51.93089431,36968000,-178000,0,178000
KRW-BTC,2023-10-16,2023-10-16T09:00:00,37087000,40700000,37000000,38697000,1.6975E+12,3.51914E+11,9125.609525,37086000,1611000,0.043439573,41.27141793,36790000,296000,296000,0
KRW-BTC,2023-10-17,2023-10-17T09:00:00,38686000,38947000,38156000,38652000,1.69759E+12,1.23062E+11,3189.767738,38697000,-45000,-0.001162881,62.07092737,37086000,1611000,1611000,0
KRW-BTC,2023-10-18,2023-10-18T09:00:00,38652000,39380000,38479000,38710000,1.69767E+12,1.04731E+11,2698.75413,38652000,58000,0.001500569,64.28992339,38697000,-45000,0,45000
KRW-BTC,2023-10-19,2023-10-19T09:00:00,38672000,39250000,38550000,39000000,1.69776E+12,1.63822E+11,4211.270405,38710000,290000,0.007491604,61.73437171,38652000,58000,58000,0
KRW-BTC,2023-10-20,2023-10-20T09:00:00,39000000,40700000,38820000,40250000,1.69785E+12,2.57643E+11,6455.833764,39000000,1250000,0.032051282,68.51615646,38710000,290000,290000,0
KRW-BTC,2023-10-21,2023-10-21T09:00:00,40250000,40745000,39975000,40400000,1.69793E+12,1.03001E+11,2554.628071,40250000,150000,0.003726708,72.64499446,39000000,1250000,1250000,0
KRW-BTC,2023-10-22,2023-10-22T09:00:00,40406000,40736000,40117000,40354000,1.69802E+12,1.10398E+11,2733.238762,40400000,-46000,-0.001138614,72.87545788,40250000,150000,150000,0
KRW-BTC,2023-10-23,2023-10-23T09:00:00,40354000,45165000,40307000,44179000,1.69811E+12,4.70737E+11,11111.9164,40354000,3825000,0.094786143,72.12995072,40400000,-46000,0,46000
KRW-BTC,2023-10-24,2023-10-24T09:00:00,44179000,47459000,43820000,45599000,1.69819E+12,7.83557E+11,17112.17695,44179000,1420000,0.032141968,86.70011148,40354000,3825000,3825000,0
KRW-BTC,2023-10-25,2023-10-25T09:00:00,45593000,47355000,45556000,46484000,1.69828E+12,3.52246E+11,7593.968957,45599000,885000,0.01940832,90.78077189,44179000,1420000,1420000,0
KRW-BTC,2023-10-26,2023-10-26T09:00:00,46485000,47093000,45631000,46141000,1.69836E+12,3.10797E+11,6702.742051,46484000,-343000,-0.007378883,97.40121727,45599000,885000,885000,0
KRW-BTC,2023-10-27,2023-10-27T09:00:00,46140000,46205000,45450000,45980000,1.69845E+12,1.41262E+11,3075.957921,46141000,-161000,-0.003489305,94.23457372,46484000,-343000,0,343000
KRW-BTC,2023-10-28,2023-10-28T09:00:00,45980000,46780000,45955000,46314000,1.69854E+12,1.01584E+11,2191.556821,45980000,334000,0.007264028,92.6785376,46141000,-161000,0,161000
KRW-BTC,2023-10-29,2023-10-29T09:00:00,46316000,47028000,46285000,46825000,1.69862E+12,1.12428E+11,2408.995269,46314000,511000,0.011033381,94.44651857,45980000,334000,334000,0
KRW-BTC,2023-10-30,2023-10-30T09:00:00,46825000,47215000,46417000,46732000,1.69871E+12,1.93673E+11,4138.817268,46825000,-93000,-0.001986119,94.55576905,46314000,511000,511000,0
KRW-BTC,2023-10-31,2023-10-31T09:00:00,46734000,47050000,46302000,47030000,1.6988E+12,1.92295E+11,4120.385152,46732000,298000,0.006376787,92.68940601,46825000,-93000,0,93000
KRW-BTC,2023-11-01,2023-11-01T09:00:00,47030000,48165000,46720000,48079000,1.69888E+12,2.99411E+11,6327.331741,47030000,1049000,0.022304912,93.3464404,46732000,298000,298000,0
KRW-BTC,2023-11-02,2023-11-02T09:00:00,48100000,48661000,46732000,47516000,1.69897E+12,2.85476E+11,5972.070398,48079000,-563000,-0.011709894,93.96527452,47030000,1049000,1049000,0
KRW-BTC,2023-11-03,2023-11-03T09:00:00,47524000,47524000,46203000,46676000,1.69906E+12,2.30048E+11,4936.170641,47516000,-840000,-0.017678256,88.96412884,48079000,-563000,0,563000
KRW-BTC,2023-11-04,2023-11-04T09:00:00,46675000,47246000,46473000,47050000,1.69914E+12,1.31308E+11,2806.918565,46676000,374000,0.008012683,80.54763263,47516000,-840000,0,840000
KRW-BTC,2023-11-05,2023-11-05T09:00:00,47052000,47500000,46670000,47056000,1.69923E+12,1.59998E+11,3392.839982,47050000,6000,0.000127524,80.95326755,46676000,374000,374000,0
KRW-BTC,2023-11-06,2023-11-06T09:00:00,47056000,47197000,46471000,46781000,1.69932E+12,1.64129E+11,3504.697103,47056000,-275000,-0.005844101,81.31190432,47050000,6000,6000,0
KRW-BTC,2023-11-07,2023-11-07T09:00:00,46781000,47696000,46300000,47301000,1.6994E+12,1.84409E+11,3939.251671,46781000,520000,0.011115624,68.19071588,47056000,-275000,0,275000
KRW-BTC,2023-11-08,2023-11-08T09:00:00,47301000,47900000,46927000,47458000,1.69949E+12,1.39386E+11,2949.257789,47301000,157000,0.003319169,63.61164427,46781000,520000,520000,0
KRW-BTC,2023-11-09,2023-11-09T09:00:00,47457000,50278000,47401000,49400000,1.69957E+12,5.46011E+11,11141.96101,47458000,1942000,0.040920393,58.81607531,47301000,157000,157000,0
KRW-BTC,2023-11-10,2023-11-10T09:00:00,49400000,50215000,48759000,50030000,1.69966E+12,2.99709E+11,6043.143625,49400000,630000,0.012753036,72.87659694,47458000,1942000,1942000,0
KRW-BTC,2023-11-11,2023-11-11T09:00:00,50030000,50100000,49230000,49629000,1.69975E+12,1.75349E+11,3533.856386,50030000,-401000,-0.008015191,76.67281349,49400000,630000,630000,0
KRW-BTC,2023-11-12,2023-11-12T09:00:00,49629000,49929000,49141000,49418000,1.69983E+12,1.61935E+11,3274.753479,49629000,-211000,-0.004251547,71.64120642,50030000,-401000,0,401000
KRW-BTC,2023-11-13,2023-11-13T09:00:00,49418000,49803000,49000000,49154000,1.69992E+12,1.78811E+11,3616.168479,49418000,-264000,-0.005342183,67.61788286,49629000,-211000,0,211000
KRW-BTC,2023-11-14,2023-11-14T09:00:00,49151000,49633000,47524000,47969000,1.70001E+12,2.88081E+11,5902.6341,49154000,-1185000,-0.024107906,66.08233732,49418000,-264000,0,264000
KRW-BTC,2023-11-15,2023-11-15T09:00:00,47969000,50552000,47018000,50457000,1.70009E+12,3.06666E+11,6306.637528,47969000,2488000,0.051866831,55.57799691,49154000,-1185000,0,1185000
KRW-BTC,2023-11-16,2023-11-16T09:00:00,50463000,50652000,48115000,48868000,1.70018E+12,2.6915E+11,5432.889659,50457000,-1589000,-0.031492162,62.06371753,47969000,2488000,2488000,0
KRW-BTC,2023-11-17,2023-11-17T09:00:00,48878000,49501000,48552000,49390000,1.70027E+12,1.70568E+11,3480.161454,48868000,522000,0.010681837,56.21209337,50457000,-1589000,0,1589000
KRW-BTC,2023-11-18,2023-11-18T09:00:00,49390000,49507000,48862000,49165000,1.70035E+12,90867746692,1849.641179,49390000,-225000,-0.004555578,62.84551306,48868000,522000,522000,0
KRW-BTC,2023-11-19,2023-11-19T09:00:00,49190000,49999000,49000000,49800000,1.70044E+12,99286328889,2013.898965,49165000,635000,0.012915692,60.15362458,49390000,-225000,0,225000
KRW-BTC,2023-11-20,2023-11-20T09:00:00,49800000,50305000,49283000,50170000,1.70052E+12,1.58066E+11,3173.091868,49800000,370000,0.007429719,62.42303513,49165000,635000,635000,0
KRW-BTC,2023-11-21,2023-11-21T09:00:00,50170000,50389000,48510000,48510000,1.70061E+12,2.55668E+11,5154.074949,50170000,-1660000,-0.033087503,65.21231708,49800000,370000,370000,0
KRW-BTC,2023-11-22,2023-11-22T09:00:00,48521000,50499000,48391000,50042000,1.7007E+12,2.07586E+11,4203.05718,48510000,1532000,0.031581117,54.92303934,50170000,-1660000,0,1660000
KRW-BTC,2023-11-23,2023-11-23T09:00:00,50050000,50253000,49500000,49929000,1.70078E+12,1.18658E+11,2375.370979,50042000,-113000,-0.002258103,59.46242859,48510000,1532000,1532000,0
KRW-BTC,2023-11-24,2023-11-24T09:00:00,49936000,51323000,49888000,50601000,1.70087E+12,1.86303E+11,3684.131036,49929000,672000,0.013459112,52.23678647,50042000,-113000,0,113000
KRW-BTC,2023-11-25,2023-11-25T09:00:00,50606000,50802000,50307000,50533000,1.70096E+12,87821072936,1735.641591,50601000,-68000,-0.001343847,52.4058313,49929000,672000,672000,0
KRW-BTC,2023-11-26,2023-11-26T09:00:00,50533000,50610000,50019000,50210000,1.70104E+12,97182147446,1931.407296,50533000,-323000,-0.006391863,53.91884862,50601000,-68000,0,68000
KRW-BTC,2023-11-27,2023-11-27T09:00:00,50210000,50446000,49500000,50275000,1.70113E+12,1.48204E+11,2967.234132,50210000,65000,0.001294563,53.40030912,50533000,-323000,0,323000
KRW-BTC,2023-11-28,2023-11-28T09:00:00,50274000,51095000,49550000,50576000,1.70122E+12,1.54385E+11,3070.185803,50275000,301000,0.005987071,54.89647943,50210000,65000,65000,0
KRW-BTC,2023-11-29,2023-11-29T09:00:00,50576000,51250000,50419000,50720000,1.7013E+12,1.43915E+11,2831.02552,50576000,144000,0.0028472,62.34024425,50275000,301000,301000,0
KRW-BTC,2023-11-30,2023-11-30T09:00:00,50720000,50963000,50445000,50586000,1.70139E+12,1.40499E+11,2773.480739,50720000,-134000,-0.002641956,51.59995133,50576000,144000,144000,0
KRW-BTC,2023-12-01,2023-12-01T09:00:00,50601000,52000000,50500000,51709000,1.70148E+12,2.06685E+11,4022.039333,50586000,1123000,0.022199818,62.69958604,50720000,-134000,0,134000
KRW-BTC,2023-12-02,2023-12-02T09:00:00,51710000,52833000,51645000,52603000,1.70156E+12,1.39928E+11,2689.116908,51709000,894000,0.01728906,65.74338086,50586000,1123000,1123000,0
KRW-BTC,2023-12-03,2023-12-03T09:00:00,52615000,53864000,52531000,53700000,1.70165E+12,1.8842E+11,3551.854502,52603000,1097000,0.020854324,71.3965646,51709000,894000,894000,0
KRW-BTC,2023-12-04,2023-12-04T09:00:00,53761000,57337000,53690000,56920000,1.70173E+12,6.34928E+11,11395.02752,53700000,3220000,0.059962756,72.9519774,52603000,1097000,1097000,0
KRW-BTC,2023-12-05,2023-12-05T09:00:00,56922000,60769000,56000000,60227000,1.70182E+12,5.80788E+11,9996.252712,56920000,3307000,0.058099086,79.74616605,53700000,3220000,3220000,0
KRW-BTC,2023-12-06,2023-12-06T09:00:00,60230000,61312000,59572000,60314000,1.70191E+12,5.3364E+11,8840.70991,60227000,87000,0.001444535,95.08966367,56920000,3307000,3307000,0
KRW-BTC,2023-12-07,2023-12-07T09:00:00,60295000,60958000,58555000,59250000,1.70199E+12,4.96929E+11,8318.924757,60314000,-1064000,-0.017641012,94.47523381,60227000,87000,87000,0
KRW-BTC,2023-12-08,2023-12-08T09:00:00,59237000,60753000,58750000,60142000,1.70208E+12,3.12889E+11,5252.133202,59250000,892000,0.015054852,87.28698296,60314000,-1064000,0,1064000
KRW-BTC,2023-12-09,2023-12-09T09:00:00,60148000,60395000,59680000,60082000,1.70217E+12,2.12176E+11,3528.907593,60142000,-60000,-0.000997639,87.50687947,59250000,892000,892000,0
KRW-BTC,2023-12-10,2023-12-10T09:00:00,60082000,60277000,59563000,59835000,1.70225E+12,1.54504E+11,2575.294711,60082000,-247000,-0.004111048,87.56195421,60142000,-60000,0,60000
KRW-BTC,2023-12-11,2023-12-11T09:00:00,59834000,59918000,55460000,56950000,1.70234E+12,6.90921E+11,11981.70049,59835000,-2885000,-0.048215927,88.08864266,60082000,-247000,0,247000
KRW-BTC,2023-12-12,2023-12-12T09:00:00,56950000,58780000,56654000,57605000,1.70243E+12,4.61429E+11,8005.13993,56950000,655000,0.011501317,71.59495309,59835000,-2885000,0,2885000
KRW-BTC,2023-12-13,2023-12-13T09:00:00,57605000,59924000,56500000,59056000,1.70251E+12,3.26098E+11,5623.204158,57605000,1451000,0.025188786,72.23100765,56950000,655000,655000,0
KRW-BTC,2023-12-14,2023-12-14T09:00:00,59056000,59500000,58002000,58735000,1.7026E+12,2.6748E+11,4548.148131,59056000,-321000,-0.005435519,74.35148399,57605000,1451000,1451000,0
KRW-BTC,2023-12-15,2023-12-15T09:00:00,58727000,58973000,57632000,58028000,1.70268E+12,2.20131E+11,3771.61725,58735000,-707000,-0.012037116,73.54793966,59056000,-321000,0,321000
KRW-BTC,2023-12-16,2023-12-16T09:00:00,58020000,58562000,57574000,57935000,1.70277E+12,1.47867E+11,2546.602555,58028000,-93000,-0.001602675,68.70965832,58735000,-707000,0,707000
KRW-BTC,2023-12-17,2023-12-17T09:00:00,57928000,58017000,56700000,56710000,1.70286E+12,1.79292E+11,3121.981611,57935000,-1225000,-0.021144386,66.57341788,58028000,-93000,0,93000
KRW-BTC,2023-12-18,2023-12-18T09:00:00,56710000,58184000,55002000,58130000,1.70294E+12,5.26899E+11,9358.518293,56710000,1420000,0.025039676,59.28210189,57935000,-1225000,0,1225000
KRW-BTC,2023-12-19,2023-12-19T09:00:00,58099000,58944000,57260000,57845000,1.70303E+12,2.7621E+11,4742.205852,58130000,-285000,-0.004902804,54.19730817,56710000,1420000,1420000,0
KRW-BTC,2023-12-20,2023-12-20T09:00:00,57840000,59873000,57580000,59351000,1.70312E+12,3.67164E+11,6248.377363,57845000,1506000,0.026035094,39.54529494,58130000,-285000,0,285000
KRW-BTC,2023-12-21,2023-12-21T09:00:00,59350000,60000000,58924000,59479000,1.7032E+12,2.67069E+11,4490.297984,59351000,128000,0.002156661,46.2415112,57845000,1506000,1506000,0
KRW-BTC,2023-12-22,2023-12-22T09:00:00,59479000,60419000,59094000,59532000,1.70329E+12,2.85752E+11,4790.38514,59479000,53000,0.000891071,50.96421053,59351000,128000,128000,0
KRW-BTC,2023-12-23,2023-12-23T09:00:00,59532000,59700000,59000000,59250000,1.70338E+12,1.38939E+11,2340.10845,59532000,-282000,-0.004736948,47.23631751,59479000,53000,53000,0
KRW-BTC,2023-12-24,2023-12-24T09:00:00,59249000,59600000,58000000,58002000,1.70346E+12,2.20017E+11,3729.33358,59250000,-1248000,-0.021063291,46.30484988,59532000,-282000,0,282000
KRW-BTC,2023-12-25,2023-12-25T09:00:00,58002000,58659000,57464000,58042000,1.70355E+12,2.72133E+11,4687.208892,58002000,40000,0.000689631,42.52386002,59250000,-1248000,0,1248000
KRW-BTC,2023-12-26,2023-12-26T09:00:00,58042000,58140000,56349000,57032000,1.70364E+12,2.70823E+11,4735.230256,58042000,-1010000,-0.017401192,55.79987253,58002000,40000,40000,0
KRW-BTC,2023-12-27,2023-12-27T09:00:00,57032000,58212000,56349000,57920000,1.70372E+12,2.2701E+11,3965.842823,57032000,888000,0.015570206,47.06725356,58042000,-1010000,0,1010000
KRW-BTC,2023-12-28,2023-12-28T09:00:00,57920000,58468000,56700000,56907000,1.70381E+12,2.26957E+11,3958.816736,57920000,-1013000,-0.017489641,43.8301108,57032000,888000,888000,0
KRW-BTC,2023-12-29,2023-12-29T09:00:00,56904000,57300000,56000000,56450000,1.70389E+12,2.41957E+11,4273.270718,56907000,-457000,-0.008030647,40.76581128,57920000,-1013000,0,1013000
KRW-BTC,2023-12-30,2023-12-30T09:00:00,56450000,57150000,56101000,56639000,1.70398E+12,1.30137E+11,2301.724829,56450000,189000,0.003348096,41.8221393,56907000,-457000,0,457000
KRW-BTC,2023-12-31,2023-12-31T09:00:00,56639000,57437000,56452000,57047000,1.70407E+12,1.31519E+11,2308.38316,56639000,408000,0.007203517,43.34975369,56450000,189000,189000,0
KRW-BTC,2024-01-01,2024-01-01T09:00:00,57045000,58847000,57045000,58839000,1.70415E+12,1.82491E+11,3165.320929,57047000,1792000,0.031412695,51.88753221,56639000,408000,408000,0
KRW-BTC,2024-01-02,2024-01-02T09:00:00,58839000,60997000,58814000,60206000,1.70424E+12,4.95039E+11,8221.198684,58839000,1367000,0.02323289,53.81223788,57047000,1792000,1792000,0
KRW-BTC,2024-01-03,2024-01-03T09:00:00,60205000,60799000,54346000,58581000,1.70433E+12,9.45841E+11,16310.30693,60206000,-1625000,-0.026990665,61.37173683,58839000,1367000,1367000,0
KRW-BTC,2024-01-04,2024-01-04T09:00:00,58581000,60162000,57319000,59477000,1.70441E+12,3.66026E+11,6254.537687,58581000,896000,0.015295062,46.33333333,60206000,-1625000,0,1625000
KRW-BTC,2024-01-05,2024-01-05T09:00:00,59477000,59695000,57577000,59351000,1.7045E+12,2.84352E+11,4822.389677,59477000,-126000,-0.002118466,49.99112531,58581000,896000,896000,0
KRW-BTC,2024-01-06,2024-01-06T09:00:00,59351000,59518000,58651000,59329000,1.70459E+12,1.46682E+11,2482.626233,59351000,-22000,-0.000370676,49.2020104,59477000,-126000,0,126000
KRW-BTC,2024-01-07,2024-01-07T09:00:00,59329000,59879000,58630000,59108000,1.70467E+12,1.95333E+11,3285.09256,59329000,-221000,-0.003724991,50.35646602,59351000,-22000,0,22000
KRW-BTC,2024-01-08,2024-01-08T09:00:00,59105000,63410000,57801000,63010000,1.70476E+12,6.77313E+11,11161.48689,59108000,3902000,0.066014753,55.50029839,59329000,-221000,0,221000
KRW-BTC,2024-01-09,2024-01-09T09:00:00,63011000,64385000,60748000,62014000,1.70484E+12,6.17115E+11,9882.551287,63010000,-996000,-0.015807015,67.84995688,59108000,3902000,3902000,0
KRW-BTC,2024-01-10,2024-01-10T09:00:00,62001000,65000000,59730000,63621000,1.70493E+12,1.02331E+12,16442.71361,62014000,1607000,0.025913503,67.91828514,63010000,-996000,0,996000
KRW-BTC,2024-01-11,2024-01-11T09:00:00,63621000,66779000,62246000,63550000,1.70502E+12,9.2398E+11,14392.35119,63621000,-71000,-0.001115984,69.49593051,62014000,1607000,1607000,0
KRW-BTC,2024-01-12,2024-01-12T09:00:00,63560000,63820000,58200000,59435000,1.7051E+12,7.0525E+11,11517.51602,63550000,-4115000,-0.064752164,74.28174574,63621000,-71000,0,71000
KRW-BTC,2024-01-13,2024-01-13T09:00:00,59430000,59860000,58174000,58968000,1.70519E+12,3.26998E+11,5542.07595,59435000,-467000,-0.007857323,58.60875584,63550000,-4115000,0,4115000
KRW-BTC,2024-01-14,2024-01-14T09:00:00,58968000,59254000,57312000,57391000,1.70528E+12,2.30963E+11,3950.547382,58968000,-1577000,-0.026743318,56.61084303,59435000,-467000,0,467000
KRW-BTC,2024-01-15,2024-01-15T09:00:00,57380000,59340000,57332000,58354000,1.70536E+12,2.31795E+11,3967.321808,57391000,963000,0.016779634,50.91567291,58968000,-1577000,0,1577000
KRW-BTC,2024-01-16,2024-01-16T09:00:00,58416000,59577000,58169000,59196000,1.70545E+12,2.20848E+11,3748.967419,58354000,842000,0.014429174,48.64940128,57391000,963000,963000,0
KRW-BTC,2024-01-17,2024-01-17T09:00:00,59218000,59300000,58269000,58776000,1.70554E+12,1.66685E+11,2837.33449,59196000,-420000,-0.007095074,47.1026965,58354000,842000,842000,0
KRW-BTC,2024-01-18,2024-01-18T09:00:00,58776000,58900000,56754000,57284000,1.70562E+12,2.47275E+11,4268.88384,58776000,-1492000,-0.025384511,50.6009245,59196000,-420000,0,420000
KRW-BTC,2024-01-19,2024-01-19T09:00:00,57281000,58180000,55935000,57739000,1.70571E+12,3.19935E+11,5634.881771,57284000,455000,0.007942881,43.48136258,58776000,-1492000,0,1492000
KRW-BTC,2024-01-20,2024-01-20T09:00:00,57738000,57796000,57242000,57517000,1.7058E+12,1.22466E+11,2127.464542,57739000,-222000,-0.003844888,45.30029155,57284000,455000,455000,0
KRW-BTC,2024-01-21,2024-01-21T09:00:00,57550000,57942000,57350000,57387000,1.70588E+12,1.15423E+11,2003.671582,57517000,-130000,-0.002260201,44.77809798,57739000,-222000,0,222000
KRW-BTC,2024-01-22,2024-01-22T09:00:00,57392000,57543000,54659000,54689000,1.70597E+12,3.54946E+11,6334.411384,57387000,-2698000,-0.047014132,45.01419549,57517000,-130000,0,130000
KRW-BTC,2024-01-23,2024-01-23T09:00:00,54689000,55576000,53125000,55389000,1.70605E+12,4.17612E+11,7696.965773,54689000,700000,0.012799649,24.08595453,57387000,-2698000,0,2698000
KRW-BTC,2024-01-24,2024-01-24T09:00:00,55389000,55850000,54446000,55200000,1.70614E+12,1.99194E+11,3615.041713,55389000,-189000,-0.00341223,28.98026525,54689000,700000,700000,0
KRW-BTC,2024-01-25,2024-01-25T09:00:00,55200000,55586000,54760000,55101000,1.70623E+12,1.58152E+11,2868.417752,55200000,-99000,-0.001793478,20.64012273,55389000,-189000,0,189000
KRW-BTC,2024-01-26,2024-01-26T09:00:00,55101000,58146000,54957000,57503000,1.70631E+12,2.97209E+11,5241.711884,55101000,2402000,0.043592675,20.59990257,55200000,-99000,0,99000
KRW-BTC,2024-01-27,2024-01-27T09:00:00,57526000,58189000,57046000,58086000,1.7064E+12,1.27857E+11,2217.235851,57503000,583000,0.010138602,42.36725664,55101000,2402000,2402000,0
KRW-BTC,2024-01-28,2024-01-28T09:00:00,58084000,58880000,57400000,57855000,1.70649E+12,1.63354E+11,2804.053163,58086000,-231000,-0.003976862,46.54713436,57503000,583000,583000,0
KRW-BTC,2024-01-29,2024-01-29T09:00:00,57855000,59210000,57561000,59101000,1.70657E+12,1.9847E+11,3400.582135,57855000,1246000,0.0215366,52.03045685,58086000,-231000,0,231000
KRW-BTC,2024-01-30,2024-01-30T09:00:00,59129000,59863000,58600000,58965000,1.70666E+12,2.43788E+11,4111.402795,59101000,-136000,-0.002301146,53.18985396,57855000,1246000,1246000,0
KRW-BTC,2024-01-31,2024-01-31T09:00:00,58966000,59848000,58221000,58738000,1.70675E+12,1.98864E+11,3372.055125,58965000,-227000,-0.003849741,48.95028629,59101000,-136000,0,136000
KRW-BTC,2024-02-01,2024-02-01T09:00:00,58730000,59302000,57804000,59150000,1.70683E+12,1.6106E+11,2757.180482,58738000,412000,0.007014199,49.82423682,58965000,-227000,0,227000
KRW-BTC,2024-02-02,2024-02-02T09:00:00,59150000,59531000,58551000,59299000,1.70692E+12,1.34729E+11,2278.873158,59150000,149000,0.002519019,59.58890031,58738000,412000,412000,0
KRW-BTC,2024-02-03,2024-02-03T09:00:00,59295000,59485000,59120000,59260000,1.707E+12,69320649323,1168.386992,59299000,-39000,-0.000657684,58.27674024,59150000,149000,149000,0
KRW-BTC,2024-02-04,2024-02-04T09:00:00,59262000,59324000,58633000,58811000,1.70709E+12,75191501973,1272.474533,59260000,-449000,-0.00757678,59.43079753,59299000,-39000,0,39000
KRW-BTC,2024-02-05,2024-02-05T09:00:00,58814000,59800000,58311000,58882000,1.70718E+12,1.6531E+11,2801.147225,58811000,71000,0.001207257,57.44769874,59260000,-449000,0,449000
KRW-BTC,2024-02-06,2024-02-06T09:00:00,58882000,59400000,58650000,59039000,1.70726E+12,1.21948E+11,2068.074811,58882000,157000,0.00266635,80.23943459,58811000,71000,71000,0
KRW-BTC,2024-02-07,2024-02-07T09:00:00,59020000,60373000,58745000,60232000,1.70735E+12,2.38382E+11,4016.912513,59039000,1193000,0.020206982,78.56025039,58882000,157000,157000,0
KRW-BTC,2024-02-08,2024-02-08T09:00:00,60242000,62200000,60232000,62011000,1.70744E+12,2.69422E+11,4403.573216,60232000,1779000,0.029535795,84.02758994,59039000,1193000,1193000,0
KRW-BTC,2024-02-09,2024-02-09T09:00:00,62011000,64955000,61717000,63682000,1.70752E+12,5.12756E+11,8059.034196,62011000,1671000,0.026946832,88.07582103,60232000,1779000,1779000,0
KRW-BTC,2024-02-10,2024-02-10T09:00:00,63682000,64890000,63062000,64549000,1.70761E+12,2.25319E+11,3520.614768,63682000,867000,0.013614522,87.03104399,62011000,1671000,1671000,0
KRW-BTC,2024-02-11,2024-02-11T09:00:00,64549000,65500000,64256000,65230000,1.7077E+12,2.38873E+11,3675.680433,64549000,681000,0.010550125,87.45798076,63682000,867000,867000,0
KRW-BTC,2024-02-12,2024-02-12T09:00:00,65231000,67444000,64887000,67002000,1.70778E+12,4.41593E+11,6674.518912,65230000,1772000,0.027165415,90.62465572,64549000,681000,681000,0
KRW-BTC,2024-02-13,2024-02-13T09:00:00,67002000,67698000,65800000,67309000,1.70787E+12,4.52458E+11,6757.732233,67002000,307000,0.004581953,91.13818598,65230000,1772000,1772000,0
KRW-BTC,2024-02-14,2024-02-14T09:00:00,67309000,70300000,66800000,70199000,1.70796E+12,5.55789E+11,8040.249489,67309000,2890000,0.042936309,92.68467362,67002000,307000,307000,0
KRW-BTC,2024-02-15,2024-02-15T09:00:00,70195000,72216000,70190000,71253000,1.70804E+12,5.96093E+11,8360.626507,70199000,1054000,0.015014459,96.07622417,67309000,2890000,2890000,0
KRW-BTC,2024-02-16,2024-02-16T09:00:00,71253000,72500000,70782000,72128000,1.70813E+12,3.51584E+11,4895.530562,71253000,875000,0.012280185,96.26882789,70199000,1054000,1054000,0
KRW-BTC,2024-02-17,2024-02-17T09:00:00,72134000,72267000,69595000,71530000,1.70821E+12,4.43405E+11,6239.936815,72128000,-598000,-0.008290816,96.4650489,71253000,875000,875000,0
KRW-BTC,2024-02-18,2024-02-18T09:00:00,71500000,72158000,70669000,71964000,1.7083E+12,2.58754E+11,3622.397043,71530000,434000,0.006067384,92.71094403,72128000,-598000,0,598000
KRW-BTC,2024-02-19,2024-02-19T09:00:00,71968000,72412000,71728000,71755000,1.70839E+12,2.58719E+11,3590.539945,71964000,-209000,-0.00290423,95.83246219,71530000,434000,434000,0
KRW-BTC,2024-02-20,2024-02-20T09:00:00,71755000,73100000,71010000,72191000,1.70847E+12,3.74957E+11,5210.953758,71755000,436000,0.006076232,94.42948851,71964000,-209000,0,209000
KRW-BTC,2024-02-21,2024-02-21T09:00:00,72160000,72465000,71100000,72397000,1.70856E+12,2.71811E+11,3784.156929,72191000,206000,0.002853541,94.53474197,71755000,436000,436000,0
KRW-BTC,2024-02-22,2024-02-22T09:00:00,72397000,72399000,71458000,71601000,1.70865E+12,2.12442E+11,2956.432904,72397000,-796000,-0.010994931,94.14326148,72191000,206000,206000,0
KRW-BTC,2024-02-23,2024-02-23T09:00:00,71600000,71835000,70657000,70805000,1.70873E+12,2.09597E+11,2937.893622,71601000,-796000,-0.011117163,87.4726477,72397000,-796000,0,796000
KRW-BTC,2024-02-24,2024-02-24T09:00:00,70804000,71467000,70542000,71107000,1.70882E+12,1.96504E+11,2768.922443,70805000,302000,0.004265236,79.87584934,71601000,-796000,0,796000
KRW-BTC,2024-02-25,2024-02-25T09:00:00,71107000,71595000,70907000,71256000,1.70891E+12,1.32977E+11,1867.428109,71107000,149000,0.002095434,78.87460373,70805000,302000,302000,0
KRW-BTC,2024-02-26,2024-02-26T09:00:00,71254000,75000000,70000000,74742000,1.70899E+12,4.45754E+11,6152.528499,71256000,3486000,0.048922196,77.83628973,71107000,149000,149000,0
KRW-BTC,2024-02-27,2024-02-27T09:00:00,74741000,79183000,74554000,78619000,1.70908E+12,7.89427E+11,10168.66848,74742000,3877000,0.051871772,80.86616685,71256000,3486000,3486000,0
KRW-BTC,2024-02-28,2024-02-28T09:00:00,78621000,88424000,78082000,87634000,1.70916E+12,1.60584E+12,19254.09747,78619000,9015000,0.114666938,85.10677924,74742000,3877000,3877000,0
KRW-BTC,2024-02-29,2024-02-29T09:00:00,87695000,90000000,85244000,85910000,1.70925E+12,1.24789E+12,14269.12684,87634000,-1724000,-0.01967273,89.20973328,78619000,9015000,9015000,0
KRW-BTC,2024-03-01,2024-03-01T09:00:00,85911000,88500000,85910000,87397000,1.70934E+12,5.45793E+11,6256.971936,85910000,1487000,0.017308812,81.99799153,87634000,-1724000,0,1724000
KRW-BTC,2024-03-02,2024-03-02T09:00:00,87397000,87724000,86090000,86383000,1.70942E+12,4.75836E+11,5481.662532,87397000,-1014000,-0.011602229,82.46651074,85910000,1487000,1487000,0
KRW-BTC,2024-03-03,2024-03-03T09:00:00,86382000,87993000,85000000,87982000,1.70951E+12,5.20339E+11,6017.571686,86383000,1599000,0.018510587,81.03296979,87397000,-1014000,0,1014000
KRW-BTC,2024-03-04,2024-03-04T09:00:00,87978000,95586000,87302000,95500000,1.7096E+12,1.2111E+12,13254.11821,87982000,7518000,0.085449296,81.91345234,86383000,1599000,1599000,0
KRW-BTC,2024-03-05,2024-03-05T09:00:00,95500000,97000000,88024000,91275000,1.70968E+12,2.06879E+12,22134.58235,95500000,-4225000,-0.044240838,86.63786453,87982000,7518000,7518000,0
KRW-BTC,2024-03-06,2024-03-06T09:00:00,91284000,94917000,88233000,93325000,1.70977E+12,1.13297E+12,12290.20386,91275000,2050000,0.0224596,76.36348566,95500000,-4225000,0,4225000
KRW-BTC,2024-03-07,2024-03-07T09:00:00,93325000,95678000,92670000,94060000,1.70986E+12,5.44938E+11,5792.492528,93325000,735000,0.007875703,77.50933277,91275000,2050000,2050000,0
KRW-BTC,2024-03-08,2024-03-08T09:00:00,94044000,98543000,94000000,96237000,1.70994E+12,8.35209E+11,8721.93322,94060000,2177000,0.023144801,79.56921294,93325000,735000,735000,0
KRW-BTC,2024-03-09,2024-03-09T09:00:00,96237000,96420000,95120000,95946000,1.71003E+12,3.78536E+11,3946.681689,96237000,-291000,-0.003023785,82.30855226,94060000,2177000,2177000,0
KRW-BTC,2024-03-10,2024-03-10T09:00:00,95946000,98445000,95904000,97495000,1.71012E+12,5.84592E+11,5997.985803,95946000,1549000,0.016144498,81.56403284,96237000,-291000,0,291000
KRW-BTC,2024-03-11,2024-03-11T09:00:00,97501000,101940000,95132000,100404000,1.7102E+12,1.39403E+12,14017.56815,97495000,2909000,0.029837428,82.19746239,95946000,1549000,1549000,0
KRW-BTC,2024-03-12,2024-03-12T09:00:00,100404000,102350000,99000000,101200000,1.71029E+12,8.40639E+11,8326.932695,100404000,796000,0.007927971,81.94174757,97495000,2909000,2909000,0
KRW-BTC,2024-03-13,2024-03-13T09:00:00,101200000,104865000,100909000,104122000,1.71037E+12,7.96117E+11,7708.119253,101200000,2922000,0.028873518,80.44164038,100404000,796000,796000,0
KRW-BTC,2024-03-14,2024-03-14T09:00:00,104121000,105000000,100000000,102506000,1.71046E+12,1.08264E+12,10526.11243,104122000,-1616000,-0.015520255,76.59698026,101200000,2922000,2922000,0
KRW-BTC,2024-03-15,2024-03-15T09:00:00,102506000,104131000,95600000,101000000,1.71055E+12,1.76853E+12,17862.96962,102506000,-1506000,-0.014691823,76.86480186,104122000,-1616000,0,1616000
KRW-BTC,2024-03-16,2024-03-16T09:00:00,101010000,102407000,95700000,96767000,1.71063E+12,7.73301E+11,7805.495377,101000000,-4233000,-0.041910891,72.00634161,102506000,-1506000,0,1506000
KRW-BTC,2024-03-17,2024-03-17T09:00:00,96769000,100299000,94300000,99922000,1.71072E+12,1.01801E+12,10512.20194,96767000,3155000,0.03260409,65.21420618,101000000,-4233000,0,4233000
KRW-BTC,2024-03-18,2024-03-18T09:00:00,99934000,100233000,97623000,99040000,1.71081E+12,6.01365E+11,6061.170573,99922000,-882000,-0.008826885,66.73112494,96767000,3155000,3155000,0
KRW-BTC,2024-03-19,2024-03-19T09:00:00,99042000,99700000,92027000,92572000,1.71089E+12,1.33325E+12,14040.62247,99040000,-6468000,-0.065306947,56.09378228,99922000,-882000,0,882000
KRW-BTC,2024-03-20,2024-03-20T09:00:00,92541000,100216000,89845000,99726000,1.71098E+12,1.3365E+12,14156.97656,92572000,7154000,0.077280387,52.07261338,99040000,-6468000,0,6468000
KRW-BTC,2024-03-21,2024-03-21T09:00:00,99726000,99801000,95000000,95552000,1.71107E+12,7.24759E+11,7441.537027,99726000,-4174000,-0.041854682,58.79427362,92572000,7154000,7154000,0
KRW-BTC,2024-03-22,2024-03-22T09:00:00,95618000,96500000,92222000,93855000,1.71115E+12,6.25975E+11,6646.708199,95552000,-1697000,-0.017759963,51.87286604,99726000,-4174000,0,4174000
KRW-BTC,2024-03-23,2024-03-23T09:00:00,93850000,95609000,92593000,93274000,1.71124E+12,3.44922E+11,3672.554446,93855000,-581000,-0.0061904,46.97347022,95552000,-1697000,0,1697000
KRW-BTC,2024-03-24,2024-03-24T09:00:00,93317000,97252000,93079000,96624000,1.71132E+12,3.69011E+11,3888.324566,93274000,3350000,0.035915689,46.62983704,93855000,-581000,0,581000
KRW-BTC,2024-03-25,2024-03-25T09:00:00,96624000,100500000,95600000,99202000,1.71141E+12,7.36915E+11,7510.923585,96624000,2578000,0.026680742,48.94915909,93274000,3350000,3350000,0
KRW-BTC,2024-03-26,2024-03-26T09:00:00,99202000,100800000,98830000,100051000,1.7115E+12,5.18625E+11,5187.825551,99202000,849000,0.008558295,48.53813972,96624000,2578000,2578000,0
KRW-BTC,2024-03-27,2024-03-27T09:00:00,100051000,101900000,98700000,99890000,1.71158E+12,6.87535E+11,6873.297069,100051000,-161000,-0.001609179,48.60439694,99202000,849000,849000,0
KRW-BTC,2024-03-28,2024-03-28T09:00:00,99890000,101725000,99251000,100900000,1.71167E+12,5.35926E+11,5332.230998,99890000,1010000,0.010111122,44.49015728,100051000,-161000,0,161000
KRW-BTC,2024-03-29,2024-03-29T09:00:00,100900000,101100000,99210000,99801000,1.71176E+12,4.35401E+11,4351.27001,100900000,-1099000,-0.010891972,47.87554897,99890000,1010000,1010000,0
KRW-BTC,2024-03-30,2024-03-30T09:00:00,99876000,100317000,99455000,99985000,1.71184E+12,1.96155E+11,1962.111495,99801000,184000,0.001843669,48.396673,100900000,-1099000,0,1099000
KRW-BTC,2024-03-31,2024-03-31T09:00:00,99985000,101133000,99930000,100970000,1.71193E+12,2.12088E+11,2112.03398,99985000,985000,0.009851478,54.82574531,99801000,184000,184000,0
KRW-BTC,2024-04-01,2024-04-01T09:00:00,100991000,101098000,98658000,100100000,1.71202E+12,4.72762E+11,4739.722305,100970000,-870000,-0.008616421,51.68099577,99985000,985000,985000,0
KRW-BTC,2024-04-02,2024-04-02T09:00:00,100100000,100100000,95000000,96053000,1.7121E+12,7.80976E+11,8066.150199,100100000,-4047000,-0.04042957,51.70089859,100970000,-870000,0,870000
KRW-BTC,2024-04-03,2024-04-03T09:00:00,96053000,97300000,94682000,96502000,1.71219E+12,4.11427E+11,4274.271136,96053000,449000,0.004674503,56.05623021,100100000,-4047000,0,4047000
KRW-BTC,2024-04-04,2024-04-04T09:00:00,96502000,99912000,95598000,99361000,1.71228E+12,4.2716E+11,4377.116344,96502000,2859000,0.029626329,42.68403377,96053000,449000,449000,0
KRW-BTC,2024-04-05,2024-04-05T09:00:00,99445000,99669000,96800000,98394000,1.71236E+12,3.46786E+11,3533.187749,99361000,-967000,-0.009732189,59.19204595,96502000,2859000,2859000,0
KRW-BTC,2024-04-06,2024-04-06T09:00:00,98385000,99888000,97745000,99023000,1.71245E+12,1.8584E+11,1885.558688,98394000,629000,0.006392666,61.35374456,99361000,-967000,0,967000
KRW-BTC,2024-04-07,2024-04-07T09:00:00,99000000,100450000,98976000,99369000,1.71253E+12,2.12381E+11,2132.302638,99023000,346000,0.003494138,64.34595997,98394000,629000,629000,0
KRW-BTC,2024-04-08,2024-04-08T09:00:00,99369000,103084000,99100000,102101000,1.71262E+12,5.71092E+11,5621.694162,99369000,2732000,0.027493484,58.05788763,99023000,346000,346000,0
KRW-BTC,2024-04-09,2024-04-09T09:00:00,102050000,102399000,98400000,99350000,1.71271E+12,4.78845E+11,4778.273799,102101000,-2751000,-0.026943909,58.43369989,99369000,2732000,2732000,0
KRW-BTC,2024-04-10,2024-04-10T09:00:00,99409000,101750000,97614000,100600000,1.71279E+12,4.27448E+11,4307.83087,99350000,1250000,0.012581782,48.16386401,102101000,-2751000,0,2751000
KRW-BTC,2024-04-11,2024-04-11T09:00:00,100601000,101452000,100031000,100541000,1.71288E+12,3.04817E+11,3026.454431,100600000,-59000,-0.000586481,51.75934186,99350000,1250000,1250000,0
KRW-BTC,2024-04-12,2024-04-12T09:00:00,100542000,101426000,98985000,99776000,1.71297E+12,5.01139E+11,5005.558568,100541000,-765000,-0.007608836,49.06641702,100600000,-59000,0,59000
KRW-BTC,2024-04-13,2024-04-13T09:00:00,99645000,100569000,95000000,97149000,1.71305E+12,9.35752E+11,9545.194281,99776000,-2627000,-0.026328977,49.93383793,100541000,-765000,0,765000
KRW-BTC,2024-04-14,2024-04-14T09:00:00,97092000,99180000,95224000,98905000,1.71314E+12,6.40496E+11,6601.797917,97149000,1756000,0.018075328,43.35395576,99776000,-2627000,0,2627000
KRW-BTC,2024-04-15,2024-04-15T09:00:00,98931000,99490000,95702000,96527000,1.71323E+12,5.72334E+11,5860.577308,98905000,-2378000,-0.024043274,45.32953363,97149000,1756000,1756000,0
KRW-BTC,2024-04-16,2024-04-16T09:00:00,96530000,96941000,93500000,95597000,1.71331E+12,5.75142E+11,6058.366705,96527000,-930000,-0.00963461,42.43489308,98905000,-2378000,0,2378000
KRW-BTC,2024-04-17,2024-04-17T09:00:00,95597000,96500000,90200000,91419000,1.7134E+12,6.60323E+11,7117.390446,95597000,-4178000,-0.0437043,48.88769636,96527000,-930000,0,930000
KRW-BTC,2024-04-18,2024-04-18T09:00:00,91439000,94200000,90000000,93356000,1.71348E+12,5.3338E+11,5793.827003,91419000,1937000,0.021188156,39.50963801,95597000,-4178000,0,4178000
KRW-BTC,2024-04-19,2024-04-19T09:00:00,93392000,95958000,88500000,93390000,1.71357E+12,8.26227E+11,8931.111653,93356000,34000,0.000364197,37.11649861,91419000,1937000,1937000,0
KRW-BTC,2024-04-20,2024-04-20T09:00:00,93390000,95600000,92615000,94805000,1.71366E+12,2.50943E+11,2666.364686,93390000,1415000,0.015151515,38.81637761,93356000,34000,34000,0
KRW-BTC,2024-04-21,2024-04-21T09:00:00,94840000,95989000,94312000,94868000,1.71374E+12,2.25328E+11,2369.212524,94805000,63000,0.000664522,40.89299594,93390000,1415000,1415000,0
KRW-BTC,2024-04-22,2024-04-22T09:00:00,94911000,97627000,94622000,97192000,1.71383E+12,3.09448E+11,3221.848892,94868000,2324000,0.024497196,40.16174863,94805000,63000,63000,0
KRW-BTC,2024-04-23,2024-04-23T09:00:00,97239000,97592000,95246000,96045000,1.71392E+12,3.05907E+11,3179.44418,97192000,-1147000,-0.011801383,39.07508791,94868000,2324000,2324000,0
KRW-BTC,2024-04-24,2024-04-24T09:00:00,96071000,96627000,92734000,93534000,1.714E+12,3.40439E+11,3593.11116,96045000,-2511000,-0.026143995,42.07927911,97192000,-1147000,0,1147000
KRW-BTC,2024-04-25,2024-04-25T09:00:00,93518000,94319000,91213000,92745000,1.71409E+12,3.48461E+11,3762.563153,93534000,-789000,-0.008435435,34.03091665,96045000,-2511000,0,2511000
KRW-BTC,2024-04-26,2024-04-26T09:00:00,92761000,93000000,91465000,91951000,1.71418E+12,1.86025E+11,2016.93752,92745000,-794000,-0.008561108,32.94390479,93534000,-789000,0,789000
KRW-BTC,2024-04-27,2024-04-27T09:00:00,91955000,92175000,90292000,91499000,1.71426E+12,2.23315E+11,2455.807117,91951000,-452000,-0.004915662,32.90215444,92745000,-794000,0,794000
KRW-BTC,2024-04-28,2024-04-28T09:00:00,91499000,92630000,90153000,90530000,1.71435E+12,1.69995E+11,1861.379901,91499000,-969000,-0.01059028,36.3579293,91951000,-452000,0,452000
KRW-BTC,2024-04-29,2024-04-29T09:00:00,90533000,92000000,88500000,91400000,1.71444E+12,4.17019E+11,4650.341622,90530000,870000,0.009610074,28.9794689,91499000,-969000,0,969000
KRW-BTC,2024-04-30,2024-04-30T09:00:00,91400000,92540000,85606000,87137000,1.71452E+12,6.47144E+11,7328.917735,91400000,-4263000,-0.046641138,36.07777114,90530000,870000,870000,0
KRW-BTC,2024-05-01,2024-05-01T09:00:00,87152000,87625000,80005000,83499000,1.71461E+12,1.24787E+12,15078.23755,87137000,-3638000,-0.041750347,30.54814679,91400000,-4263000,0,4263000
KRW-BTC,2024-05-02,2024-05-02T09:00:00,83499000,84000000,80601000,83078000,1.71469E+12,4.62472E+11,5609.702367,83499000,-421000,-0.005041977,31.3260398,87137000,-3638000,0,3638000
KRW-BTC,2024-05-03,2024-05-03T09:00:00,83096000,89821000,82807000,89291000,1.71478E+12,6.93338E+11,8040.25384,83078000,6213000,0.074785142,23.90045708,83499000,-421000,0,421000
KRW-BTC,2024-05-04,2024-05-04T09:00:00,89291000,91123000,87910000,90303000,1.71487E+12,3.77189E+11,4208.088961,89291000,1012000,0.011333729,42.07738993,83078000,6213000,6213000,0
KRW-BTC,2024-05-05,2024-05-05T09:00:00,90303000,90759000,88331000,90061000,1.71495E+12,2.28798E+11,2550.738184,90303000,-242000,-0.002679867,41.16076337,89291000,1012000,1012000,0
KRW-BTC,2024-05-06,2024-05-06T09:00:00,90100000,91681000,88500000,88804000,1.71504E+12,3.59038E+11,3986.164582,90061000,-1257000,-0.013957207,40.62780269,90303000,-242000,0,242000
KRW-BTC,2024-05-07,2024-05-07T09:00:00,88780000,90157000,87500000,87595000,1.71513E+12,2.59678E+11,2916.803769,88804000,-1209000,-0.013614252,32.93595899,90061000,-1257000,0,1257000
KRW-BTC,2024-05-08,2024-05-08T09:00:00,87595000,88566000,85109000,85872000,1.71521E+12,3.32701E+11,3819.527758,87595000,-1723000,-0.019670073,32.85308442,88804000,-1209000,0,1209000
KRW-BTC,2024-05-09,2024-05-09T09:00:00,85872000,88500000,85020000,88116000,1.7153E+12,2.67646E+11,3096.809344,85872000,2244000,0.026131917,33.9384538,87595000,-1723000,0,1723000
KRW-BTC,2024-05-10,2024-05-10T09:00:00,88116000,88480000,85120000,85842000,1.71539E+12,2.84535E+11,3277.857229,88116000,-2274000,-0.025806891,40.85430908,85872000,2244000,2244000,0
KRW-BTC,2024-05-11,2024-05-11T09:00:00,85842000,86500000,85209000,85791000,1.71547E+12,1.11472E+11,1299.781493,85842000,-51000,-0.000594115,38.59708067,88116000,-2274000,0,2274000
KRW-BTC,2024-05-12,2024-05-12T09:00:00,85791000,86978000,85618000,86521000,1.71556E+12,89929598339,1042.823712,85791000,730000,0.008509051,39.183658,85842000,-51000,0,51000
KRW-BTC,2024-05-13,2024-05-13T09:00:00,86521000,88485000,85410000,87928000,1.71564E+12,2.69283E+11,3085.907006,86521000,1407000,0.016261948,42.33372853,85791000,730000,730000,0
KRW-BTC,2024-05-14,2024-05-14T09:00:00,87934000,88225000,85801000,86500000,1.71573E+12,2.39137E+11,2756.811579,87928000,-1428000,-0.016240561,43.49422875,86521000,1407000,1407000,0
KRW-BTC,2024-05-15,2024-05-15T09:00:00,86500000,92444000,86200000,92111000,1.71582E+12,4.73735E+11,5272.786526,86500000,5611000,0.064867052,48.66451424,87928000,-1428000,0,1428000
KRW-BTC,2024-05-16,2024-05-16T09:00:00,92111000,92860000,90250000,90800000,1.7159E+12,3.347E+11,3657.228846,92111000,-1311000,-0.014232828,66.67570289,86500000,5611000,5611000,0
KRW-BTC,2024-05-17,2024-05-17T09:00:00,90839000,93123000,90700000,92646000,1.71599E+12,2.49519E+11,2713.819332,90800000,1846000,0.020330397,64.4541779,92111000,-1311000,0,1311000
KRW-BTC,2024-05-18,2024-05-18T09:00:00,92632000,93500000,92337000,93066000,1.71608E+12,1.69295E+11,1821.32715,92646000,420000,0.004533385,57.50727232,90800000,1846000,1846000,0
KRW-BTC,2024-05-19,2024-05-19T09:00:00,93066000,93990000,91843000,92185000,1.71616E+12,2.17038E+11,2335.848485,93066000,-881000,-0.0094664,56.35084816,92646000,420000,420000,0
KRW-BTC,2024-05-20,2024-05-20T09:00:00,92185000,97264000,91931000,97260000,1.71625E+12,4.16886E+11,4413.186165,92185000,5075000,0.05505234,54.74276527,93066000,-881000,0,881000
KRW-BTC,2024-05-21,2024-05-21T09:00:00,97260000,98150000,95571000,96700000,1.71634E+12,4.47572E+11,4609.756504,97260000,-560000,-0.005757763,66.13124762,92185000,5075000,5075000,0
KRW-BTC,2024-05-22,2024-05-22T09:00:00,96717000,96999000,94640000,95421000,1.71642E+12,2.68538E+11,2799.80157,96700000,-1279000,-0.013226474,67.81033606,97260000,-560000,0,560000
KRW-BTC,2024-05-23,2024-05-23T09:00:00,95421000,96881000,93000000,94900000,1.71651E+12,4.17507E+11,4396.134362,95421000,-521000,-0.005460014,69.0090377,96700000,-1279000,0,1279000
KRW-BTC,2024-05-24,2024-05-24T09:00:00,94897000,96160000,93300000,95214000,1.7166E+12,2.3551E+11,2489.941833,94900000,314000,0.003308746,64.4994443,95421000,-521000,0,521000
KRW-BTC,2024-05-25,2024-05-25T09:00:00,95214000,96598000,95192000,96240000,1.71668E+12,1.39438E+11,1452.896413,95214000,1026000,0.010775726,71.86246151,94900000,314000,314000,0
KRW-BTC,2024-05-26,2024-05-26T09:00:00,96240000,96590000,95400000,95610000,1.71677E+12,1.52195E+11,1583.871583,96240000,-630000,-0.006546135,73.31429336,95214000,1026000,1026000,0
KRW-BTC,2024-05-27,2024-05-27T09:00:00,95634000,97360000,95050000,96050000,1.71685E+12,2.56304E+11,2667.483476,95610000,440000,0.004602029,70.37070241,96240000,-630000,0,630000
KRW-BTC,2024-05-28,2024-05-28T09:00:00,96050000,96119000,93654000,94600000,1.71694E+12,3.00604E+11,3176.963203,96050000,-1450000,-0.015096304,69.02820729,95610000,440000,440000,0
KRW-BTC,2024-05-29,2024-05-29T09:00:00,94654000,95232000,93440000,93910000,1.71703E+12,2.33226E+11,2475.187888,94600000,-690000,-0.007293869,68.95712413,96050000,-1450000,0,1450000
KRW-BTC,2024-05-30,2024-05-30T09:00:00,93910000,96120000,93620000,94943000,1.71711E+12,2.55996E+11,2703.786212,93910000,1033000,0.010999894,55.47041294,94600000,-690000,0,690000
KRW-BTC,2024-05-31,2024-05-31T09:00:00,95005000,96000000,93700000,94505000,1.7172E+12,2.09051E+11,2203.223325,94943000,-438000,-0.004613294,62.81472317,93910000,1033000,1033000,0
KRW-BTC,2024-06-01,2024-06-01T09:00:00,94504000,94850000,94361000,94720000,1.71729E+12,58706044441,620.250351,94505000,215000,0.002275012,56.2987057,94943000,-438000,0,438000
KRW-BTC,2024-06-02,2024-06-02T09:00:00,94762000,95626000,94500000,95000000,1.71737E+12,1.05872E+11,1113.859827,94720000,280000,0.002956081,55.68306762,94505000,215000,215000,0
KRW-BTC,2024-06-03,2024-06-03T09:00:00,95000000,97358000,94825000,95994000,1.71746E+12,2.67415E+11,2779.476848,95000000,994000,0.010463158,60.08888252,94720000,280000,280000,0
KRW-BTC,2024-06-04,2024-06-04T09:00:00,95994000,97927000,95520000,97500000,1.71755E+12,2.61246E+11,2699.305313,95994000,1506000,0.015688481,43.58662614,95000000,994000,994000,0
KRW-BTC,2024-06-05,2024-06-05T09:00:00,97490000,98989000,97280000,98385000,1.71763E+12,2.66053E+11,2709.004691,97500000,885000,0.009076923,53.69822485,95994000,1506000,1506000,0
KRW-BTC,2024-06-06,2024-06-06T09:00:00,98385000,99400000,98009000,98334000,1.71772E+12,2.19522E+11,2226.539845,98385000,-51000,-0.000518372,64.2199194,97500000,885000,885000,0
KRW-BTC,2024-06-07,2024-06-07T09:00:00,98320000,99650000,97219000,97919000,1.7178E+12,3.26991E+11,3319.131949,98334000,-415000,-0.00422031,67.2528135,98385000,-51000,0,51000
KRW-BTC,2024-06-08,2024-06-08T09:00:00,97919000,98278000,97750000,98125000,1.71789E+12,1.06164E+11,1083.634531,97919000,206000,0.00210378,63.45369541,98334000,-415000,0,415000
KRW-BTC,2024-06-09,2024-06-09T09:00:00,98137000,98400000,97710000,97983000,1.71798E+12,88498186805,903.0458546,98125000,-142000,-0.001447134,60.20794975,97919000,206000,206000,0
KRW-BTC,2024-06-10,2024-06-10T09:00:00,97983000,98031000,96980000,97276000,1.71806E+12,1.45257E+11,1491.308621,97983000,-707000,-0.007215537,63.567753,98125000,-142000,0,142000
KRW-BTC,2024-06-11,2024-06-11T09:00:00,97279000,97350000,93821000,95329000,1.71815E+12,3.69758E+11,3889.452394,97276000,-1947000,-0.020015214,56.80204172,97983000,-707000,0,707000
KRW-BTC,2024-06-12,2024-06-12T09:00:00,95329000,98204000,94502000,95934000,1.71824E+12,3.27468E+11,3395.539575,95329000,605000,0.006346442,53.83321064,97276000,-1947000,0,1947000
KRW-BTC,2024-06-13,2024-06-13T09:00:00,95930000,96356000,94107000,94614000,1.71832E+12,2.05687E+11,2161.159812,95934000,-1320000,-0.01375946,60.7385399,95329000,605000,605000,0
KRW-BTC,2024-06-14,2024-06-14T09:00:00,94614000,95202000,93001000,93978000,1.71841E+12,2.10324E+11,2232.32985,94614000,-636000,-0.00672205,48.30604469,95934000,-1320000,0,1320000
KRW-BTC,2024-06-15,2024-06-15T09:00:00,93979000,94268000,93546000,93910000,1.7185E+12,85103451470,906.4181863,93978000,-68000,-0.000723574,47.34080129,94614000,-636000,0,636000
KRW-BTC,2024-06-16,2024-06-16T09:00:00,93913000,94708000,93611000,94219000,1.71858E+12,79272815453,841.9041221,93910000,309000,0.003290384,45.85125999,93978000,-68000,0,68000
KRW-BTC,2024-06-17,2024-06-17T09:00:00,94219000,94442000,91559000,93588000,1.71867E+12,3.07093E+11,3306.859877,94219000,-631000,-0.006697163,46.01164335,93910000,309000,309000,0
KRW-BTC,2024-06-18,2024-06-18T09:00:00,93589000,93699000,90638000,91649000,1.71876E+12,2.8329E+11,3084.476569,93588000,-1939000,-0.020718468,37.24013577,94219000,-631000,0,631000
KRW-BTC,2024-06-19,2024-06-19T09:00:00,91649000,92727000,91170000,91555000,1.71884E+12,1.57281E+11,1711.117488,91649000,-94000,-0.001025652,20.33262347,93588000,-1939000,0,1939000
KRW-BTC,2024-06-20,2024-06-20T09:00:00,91549000,93581000,91500000,91780000,1.71893E+12,1.83663E+11,1989.149986,91555000,225000,0.002457539,12.34840132,91649000,-94000,0,94000
KRW-BTC,2024-06-21,2024-06-21T09:00:00,91753000,92031000,89501000,90308000,1.71901E+12,2.45462E+11,2713.721229,91780000,-1472000,-0.016038353,14.54997836,91555000,225000,225000,0
KRW-BTC,2024-06-22,2024-06-22T09:00:00,90308000,91086000,90141000,90874000,1.7191E+12,58876597356,648.5146252,90308000,566000,0.00626744,13.05698476,91780000,-1472000,0,1472000
KRW-BTC,2024-06-23,2024-06-23T09:00:00,90874000,91382000,89033000,89046000,1.71919E+12,97216083241,1076.737898,90874000,-1828000,-0.020115765,15.99287121,90308000,566000,566000,0
KRW-BTC,2024-06-24,2024-06-24T09:00:00,89100000,89441000,83101000,85496000,1.71927E+12,6.42783E+11,7434.829264,89046000,-3550000,-0.039867035,13.80902243,90874000,-1828000,0,1828000
KRW-BTC,2024-06-25,2024-06-25T09:00:00,85495000,87981000,85032000,87450000,1.71936E+12,2.90625E+11,3359.068851,85496000,1954000,0.02285487,11.2244898,89046000,-3550000,0,3550000
KRW-BTC,2024-06-26,2024-06-26T09:00:00,87463000,88356000,85930000,86027000,1.71945E+12,1.70173E+11,1958.866524,87450000,-1423000,-0.016272156,24.07712048,85496000,1954000,1954000,0
KRW-BTC,2024-06-27,2024-06-27T09:00:00,86092000,87957000,85396000,86884000,1.71953E+12,1.62614E+11,1879.370916,86027000,857000,0.009961989,19.06962223,87450000,-1423000,0,1423000
KRW-BTC,2024-06-28,2024-06-28T09:00:00,86875000,87510000,84740000,85158000,1.71962E+12,1.8174E+11,2112.307663,86884000,-1726000,-0.019865568,25.14789095,86027000,857000,857000,0
KRW-BTC,2024-06-29,2024-06-29T09:00:00,85157000,86000000,85102000,85765000,1.71971E+12,64278180309,750.2984764,85158000,607000,0.007127927,23.50078116,86884000,-1726000,0,1726000
KRW-BTC,2024-06-30,2024-06-30T09:00:00,85765000,88490000,85370000,87920000,1.71979E+12,1.22284E+11,1407.837442,85765000,2155000,0.0251268,26.29649031,85158000,607000,607000,0
KRW-BTC,2024-07-01,2024-07-01T09:00:00,87920000,89644000,87609000,88253000,1.71988E+12,1.8791E+11,2120.477782,87920000,333000,0.003787534,33.4472066,85765000,2155000,2155000,0
KRW-BTC,2024-07-02,2024-07-02T09:00:00,88259000,88847000,86987000,87248000,1.71996E+12,1.33974E+11,1525.132371,88253000,-1005000,-0.011387715,35.7573816,87920000,333000,333000,0
KRW-BTC,2024-07-03,2024-07-03T09:00:00,87270000,87623000,84508000,85331000,1.72005E+12,2.41697E+11,2823.976175,87248000,-1917000,-0.02197185,37.6341669,88253000,-1005000,0,1005000
KRW-BTC,2024-07-04,2024-07-04T09:00:00,85331000,85592000,81207000,81680000,1.72014E+12,5.08714E+11,6151.28765,85331000,-3651000,-0.042786326,34.13701703,87248000,-1917000,0,1917000
KRW-BTC,2024-07-05,2024-07-05T09:00:00,81680000,82544000,77335000,81118000,1.72022E+12,7.7138E+11,9719.196675,81680000,-562000,-0.006880509,28.08540184,85331000,-3651000,0,3651000
KRW-BTC,2024-07-06,2024-07-06T09:00:00,81118000,83202000,79938000,82826000,1.72031E+12,2.1702E+11,2664.499671,81118000,1708000,0.021055746,29.24008313,81680000,-562000,0,562000
KRW-BTC,2024-07-07,2024-07-07T09:00:00,82850000,82940000,79280000,79397000,1.7204E+12,2.05365E+11,2527.24731,82826000,-3429000,-0.041400044,32.71180615,81118000,1708000,1708000,0
KRW-BTC,2024-07-08,2024-07-08T09:00:00,79397000,82700000,77880000,80534000,1.72048E+12,4.07496E+11,5094.765714,79397000,1137000,0.01432044,30.6065844,82826000,-3429000,0,3429000
KRW-BTC,2024-07-09,2024-07-09T09:00:00,80499000,82300000,80000000,82043000,1.72057E+12,2.07189E+11,2547.621846,80534000,1509000,0.018737428,38.95566239,79397000,1137000,1137000,0
KRW-BTC,2024-07-10,2024-07-10T09:00:00,82043000,83825000,81096000,81896000,1.72066E+12,2.41533E+11,2927.479725,82043000,-147000,-0.001791743,37.72196739,80534000,1509000,1509000,0
KRW-BTC,2024-07-11,2024-07-11T09:00:00,81926000,83795000,81000000,81070000,1.72074E+12,2.40656E+11,2930.427308,81896000,-826000,-0.010085963,40.04242395,82043000,-147000,0,147000
KRW-BTC,2024-07-12,2024-07-12T09:00:00,81070000,82309000,80085000,81540000,1.72083E+12,1.6237E+11,2003.05277,81070000,470000,0.005797459,35.96465817,81896000,-826000,0,826000
KRW-BTC,2024-07-13,2024-07-13T09:00:00,81548000,83700000,81300000,82901000,1.72092E+12,1.39901E+11,1698.967023,81540000,1361000,0.016691195,40.70209704,81070000,470000,470000,0
KRW-BTC,2024-07-14,2024-07-14T09:00:00,82901000,86000000,82860000,85430000,1.721E+12,2.67061E+11,3162.562054,82901000,2529000,0.030506267,42.91439881,81540000,1361000,1361000,0
KRW-BTC,2024-07-15,2024-07-15T09:00:00,85430000,91294000,85269000,91162000,1.72109E+12,4.4927E+11,5087.504768,85430000,5732000,0.067095868,43.9516129,82901000,2529000,2529000,0
KRW-BTC,2024-07-16,2024-07-16T09:00:00,91162000,91544000,87300000,90807000,1.72117E+12,5.57878E+11,6229.900821,91162000,-355000,-0.003894166,55.59789093,85430000,5732000,5732000,0
KRW-BTC,2024-07-17,2024-07-17T09:00:00,90825000,92159000,89380000,89467000,1.72126E+12,3.35602E+11,3690.869429,90807000,-1340000,-0.014756572,57.02443453,91162000,-355000,0,355000
KRW-BTC,2024-07-18,2024-07-18T09:00:00,89452000,91200000,89049000,89850000,1.72135E+12,2.31609E+11,2571.165921,89467000,383000,0.004280908,58.35353046,90807000,-1340000,0,1340000
KRW-BTC,2024-07-19,2024-07-19T09:00:00,89850000,94073000,88675000,93004000,1.72143E+12,3.85984E+11,4216.761047,89850000,3154000,0.035102949,69.01061057,89467000,383000,383000,0
KRW-BTC,2024-07-20,2024-07-20T09:00:00,93004000,94624000,92736000,94065000,1.72152E+12,1.84107E+11,1966.82922,93004000,1061000,0.011408112,74.68023256,89850000,3154000,3154000,0
KRW-BTC,2024-07-21,2024-07-21T09:00:00,94073000,95299000,92413000,95000000,1.72161E+12,2.82512E+11,2999.300042,94065000,935000,0.009939935,73.98113771,93004000,1061000,1061000,0
KRW-BTC,2024-07-22,2024-07-22T09:00:00,95000000,95353000,93050000,94357000,1.72169E+12,2.70086E+11,2864.068723,95000000,-643000,-0.006768421,87.25822628,94065000,935000,935000,0
KRW-BTC,2024-07-23,2024-07-23T09:00:00,94284000,94748000,92000000,92230000,1.72178E+12,2.98055E+11,3198.172668,94357000,-2127000,-0.022542048,83.80533138,95000000,-643000,0,643000
KRW-BTC,2024-07-24,2024-07-24T09:00:00,92196000,93494000,91051000,91501000,1.72187E+12,2.87758E+11,3120.287339,92230000,-729000,-0.007904153,74.18221526,94357000,-2127000,0,2127000
KRW-BTC,2024-07-25,2024-07-25T09:00:00,91501000,93138000,89202000,92465000,1.72195E+12,3.84023E+11,4242.3426,91501000,964000,0.010535404,72.18757219,92230000,-729000,0,729000
KRW-BTC,2024-07-26,2024-07-26T09:00:00,92475000,95000000,92286000,94727000,1.72204E+12,3.06215E+11,3254.872166,92465000,2262000,0.02446331,76.15571776,91501000,964000,964000,0
KRW-BTC,2024-07-27,2024-07-27T09:00:00,94639000,96813000,93150000,94292000,1.72212E+12,4.67925E+11,4913.83842,94727000,-435000,-0.004592144,77.96818664,92465000,2262000,2262000,0
KRW-BTC,2024-07-28,2024-07-28T09:00:00,94341000,95380000,93600000,95363000,1.72221E+12,1.94538E+11,2056.698569,94292000,1071000,0.011358334,75.1468056,94727000,-435000,0,435000
KRW-BTC,2024-07-29,2024-07-29T09:00:00,95363000,97100000,93203000,93618000,1.7223E+12,4.5658E+11,4778.708281,95363000,-1745000,-0.018298502,73.43683639,94292000,1071000,1071000,0
KRW-BTC,2024-07-30,2024-07-30T09:00:00,93605000,93878000,91825000,92788000,1.72238E+12,2.62705E+11,2825.618833,93618000,-830000,-0.008865816,57.13787491,95363000,-1745000,0,1745000
KRW-BTC,2024-07-31,2024-07-31T09:00:00,92790000,93298000,90345000,90345000,1.72247E+12,2.84978E+11,3099.028443,92788000,-2443000,-0.026328836,55.60269246,93618000,-830000,0,830000
KRW-BTC,2024-08-01,2024-08-01T09:00:00,90346000,92300000,88001000,91789000,1.72256E+12,4.54095E+11,5048.045529,90345000,1444000,0.015983176,52.33734427,92788000,-2443000,0,2443000
KRW-BTC,2024-08-02,2024-08-02T09:00:00,91789000,92200000,86377000,86691000,1.72264E+12,4.53754E+11,5089.662503,91789000,-5098000,-0.055540424,54.88585395,90345000,1444000,1444000,0
KRW-BTC,2024-08-03,2024-08-03T09:00:00,86691000,87690000,85000000,85957000,1.72273E+12,3.50472E+11,4059.375137,86691000,-734000,-0.008466854,35.51200257,91789000,-5098000,0,5098000
KRW-BTC,2024-08-04,2024-08-04T09:00:00,85954000,86311000,81684000,81871000,1.72282E+12,3.8029E+11,4532.633978,85957000,-4086000,-0.047535396,31.10904007,86691000,-734000,0,734000
KRW-BTC,2024-08-05,2024-08-05T09:00:00,81871000,82256000,72100000,77833000,1.7229E+12,1.82823E+12,23878.79267,81871000,-4038000,-0.049321494,23.32696762,85957000,-4086000,0,4086000
KRW-BTC,2024-08-06,2024-08-06T09:00:00,77786000,82150000,77782000,80224000,1.72299E+12,6.30449E+11,7868.467001,77833000,2391000,0.030719618,20.49917875,81871000,-4038000,0,4038000
KRW-BTC,2024-08-07,2024-08-07T09:00:00,80166000,81950000,77782000,78388000,1.72308E+12,4.25827E+11,5316.477661,80224000,-1836000,-0.022885919,28.76547577,77833000,2391000,2391000,0
KRW-BTC,2024-08-08,2024-08-08T09:00:00,78386000,87980000,77941000,86397000,1.72316E+12,5.89875E+11,7126.012696,78388000,8009000,0.102171251,27.68151956,80224000,-1836000,0,1836000
KRW-BTC,2024-08-09,2024-08-09T09:00:00,86397000,86704000,84000000,85518000,1.72325E+12,3.32298E+11,3892.859742,86397000,-879000,-0.010173964,41.66986986,78388000,8009000,8009000,0
KRW-BTC,2024-08-10,2024-08-10T09:00:00,85522000,86370000,84760000,85669000,1.72333E+12,1.27297E+11,1489.633875,85518000,151000,0.00176571,36.85892862,86397000,-879000,0,879000
KRW-BTC,2024-08-11,2024-08-11T09:00:00,85669000,86424000,82208000,82815000,1.72342E+12,2.25285E+11,2669.172656,85669000,-2854000,-0.033314268,37.59459071,85518000,151000,151000,0
KRW-BTC,2024-08-12,2024-08-12T09:00:00,82816000,85000000,81000000,83221000,1.72351E+12,4.20486E+11,5072.096721,82815000,406000,0.004902494,32.82883573,85669000,-2854000,0,2854000
KRW-BTC,2024-08-13,2024-08-13T09:00:00,83207000,85770000,82050000,84600000,1.72359E+12,2.50426E+11,2989.812152,83221000,1379000,0.016570337,35.23111452,82815000,406000,406000,0
KRW-BTC,2024-08-14,2024-08-14T09:00:00,84587000,85950000,82218000,82457000,1.72368E+12,3.01026E+11,3583.124953,84600000,-2143000,-0.025330969,38.54761106,83221000,1379000,1379000,0
KRW-BTC,2024-08-15,2024-08-15T09:00:00,82440000,83555000,79500000,81004000,1.72377E+12,3.25802E+11,3986.431857,82457000,-1453000,-0.017621306,38.87384338,84600000,-2143000,0,2143000
KRW-BTC,2024-08-16,2024-08-16T09:00:00,81044000,83400000,80296000,82209000,1.72385E+12,2.14699E+11,2629.819076,81004000,1205000,0.014875809,34.79143752,82457000,-1453000,0,1453000
KRW-BTC,2024-08-17,2024-08-17T09:00:00,82185000,83000000,82042000,82849000,1.72394E+12,73291253043,887.0764146,82209000,640000,0.007785036,42.9001394,81004000,1205000,1205000,0
KRW-BTC,2024-08-18,2024-08-18T09:00:00,82821000,83679000,81500000,81500000,1.72403E+12,1.43256E+11,1727.833713,82849000,-1349000,-0.016282635,45.06196378,82209000,640000,640000,0
KRW-BTC,2024-08-19,2024-08-19T09:00:00,81500000,81915000,80100000,81680000,1.72411E+12,2.14079E+11,2644.341291,81500000,180000,0.002208589,49.35440086,82849000,-1349000,0,1349000
KRW-BTC,2024-08-20,2024-08-20T09:00:00,81678000,83400000,80501000,80751000,1.7242E+12,2.741E+11,3339.761125,81680000,-929000,-0.011373653,57.73266332,81500000,180000,180000,0
KRW-BTC,2024-08-21,2024-08-21T09:00:00,80751000,83600000,80567000,82900000,1.72428E+12,2.35879E+11,2882.785489,80751000,2149000,0.026612674,51.12544313,81680000,-929000,0,929000
KRW-BTC,2024-08-22,2024-08-22T09:00:00,82900000,83101000,81280000,82003000,1.72437E+12,1.76142E+11,2138.235685,82900000,-897000,-0.010820265,59.50855601,80751000,2149000,2149000,0
KRW-BTC,2024-08-23,2024-08-23T09:00:00,82003000,86500000,82002000,85600000,1.72446E+12,3.7689E+11,4485.272039,82003000,3597000,0.043864249,36.77621283,82900000,-897000,0,897000
KRW-BTC,2024-08-24,2024-08-24T09:00:00,85600000,86390000,85155000,85767000,1.72454E+12,1.8901E+11,2204.280318,85600000,167000,0.001950935,50.21208359,82003000,3597000,3597000,0
KRW-BTC,2024-08-25,2024-08-25T09:00:00,85807000,86979000,85410000,86254000,1.72463E+12,1.45982E+11,1698.816382,85767000,487000,0.005678175,50.25325615,85600000,167000,167000,0
KRW-BTC,2024-08-26,2024-08-26T09:00:00,86227000,86529000,84408000,84408000,1.72472E+12,1.92748E+11,2260.537399,86254000,-1846000,-0.021401906,60.1260232,85767000,487000,487000,0
KRW-BTC,2024-08-27,2024-08-27T09:00:00,84408000,84794000,80121000,80950000,1.7248E+12,3.35829E+11,4066.749057,84408000,-3458000,-0.040967681,53.22186635,86254000,-1846000,0,1846000
KRW-BTC,2024-08-28,2024-08-28T09:00:00,80947000,81895000,79550000,80569000,1.72489E+12,3.10686E+11,3848.303642,80950000,-381000,-0.004706609,41.09756098,84408000,-3458000,0,3458000
KRW-BTC,2024-08-29,2024-08-29T09:00:00,80618000,82700000,80151000,80790000,1.72498E+12,2.06219E+11,2539.082478,80569000,221000,0.002742991,44.96210908,80950000,-381000,0,381000
KRW-BTC,2024-08-30,2024-08-30T09:00:00,80745000,81250000,79225000,80439000,1.72506E+12,2.29386E+11,2858.219805,80790000,-351000,-0.004344597,49.38878099,80569000,221000,221000,0
KRW-BTC,2024-08-31,2024-08-31T09:00:00,80439000,80823000,80009000,80262000,1.72515E+12,67710249600,841.9958026,80439000,-177000,-0.002200425,44.68532308,80790000,-351000,0,351000
KRW-BTC,2024-09-01,2024-09-01T09:00:00,80300000,80370000,78300000,78301000,1.72524E+12,2.01464E+11,2541.940422,80262000,-1961000,-0.024432484,42.01000679,80439000,-177000,0,177000
KRW-BTC,2024-09-02,2024-09-02T09:00:00,78303000,80610000,78235000,80205000,1.72532E+12,1.74933E+11,2207.598606,78301000,1904000,0.02431642,40.47973335,80262000,-1961000,0,1961000
KRW-BTC,2024-09-03,2024-09-03T09:00:00,80247000,81101000,78250000,78272000,1.72541E+12,2.03979E+11,2562.511724,80205000,-1933000,-0.024100742,46.01889339,78301000,1904000,1904000,0
KRW-BTC,2024-09-04,2024-09-04T09:00:00,78270000,79300000,76248000,78739000,1.72549E+12,3.01711E+11,3895.413947,78272000,467000,0.005966374,43.65302883,80205000,-1933000,0,1933000
KRW-BTC,2024-09-05,2024-09-05T09:00:00,78739000,79131000,76000000,76330000,1.72558E+12,2.27923E+11,2957.703391,78739000,-2409000,-0.03059475,38.34257858,78272000,467000,467000,0
KRW-BTC,2024-09-06,2024-09-06T09:00:00,76330000,76860000,72200000,73644000,1.72567E+12,4.53955E+11,6081.771852,76330000,-2686000,-0.03518931,35.3479002,78739000,-2409000,0,2409000
KRW-BTC,2024-09-07,2024-09-07T09:00:00,73644000,74580000,73078000,73640000,1.72575E+12,1.32926E+11,1801.620275,73644000,-4000,-5.43E-05,17.5954033,76330000,-2686000,0,2686000
KRW-BTC,2024-09-08,2024-09-08T09:00:00,73640000,74880000,72992000,74437000,1.72584E+12,1.176E+11,1592.040018,73640000,797000,0.010822922,16.83893902,73644000,-4000,0,4000
KRW-BTC,2024-09-09,2024-09-09T09:00:00,74439000,78500000,74093000,77275000,1.72593E+12,2.35312E+11,3101.054865,74437000,2838000,0.038126201,18.22532939,73640000,797000,797000,0
KRW-BTC,2024-09-10,2024-09-10T09:00:00,77274000,78485000,76432000,78089000,1.72601E+12,1.69363E+11,2189.560807,77275000,814000,0.010533808,31.79149436,74437000,2838000,2838000,0
KRW-BTC,2024-09-11,2024-09-11T09:00:00,78091000,78200000,75380000,77301000,1.7261E+12,2.34573E+11,3055.314038,78089000,-788000,-0.01009105,41.55698519,77275000,814000,814000,0
KRW-BTC,2024-09-12,2024-09-12T09:00:00,77363000,78830000,77300000,78269000,1.72619E+12,1.96214E+11,2510.012594,77301000,968000,0.012522477,40.58213256,78089000,-788000,0,788000
KRW-BTC,2024-09-13,2024-09-13T09:00:00,78269000,81100000,77700000,80930000,1.72627E+12,2.25703E+11,2847.08605,78269000,2661000,0.033998135,43.03475714,77301000,968000,968000,0
KRW-BTC,2024-09-14,2024-09-14T09:00:00,80930000,81174000,80806000,80880000,1.72628E+12,24471114305,302.0595288,80930000,-50000,-0.000617818,51.20301857,78269000,2661000,2661000,0
